gene.symbol	organs_affected
HMX1	Eye
CEP290	Kidney Renal Tract
FLNA	Face
SLX4	Bone Marrow/Immune
ARG1	Endocrine/Metabolic
POLR3A	Teeth & Dentitian
ATR	Face
FANCB	Bone Marrow/Immune
ALG9	Endocrine/Metabolic
NTRK1	Spinal cord/Peripheral nerves
MYH9	Bone Marrow/Immune
YAP1	Kidney Renal Tract
BBS9	Skeleton
TRIM32	Musculature
PAX2	Kidney Renal Tract
FGFR3	Skin
NSD1	Face
ADAR	Brain/Cognition
MTOR	Brain/Cognition
MFRP	Eye
FEZF1	Genitalia
FLNB	Skeleton
NAA10	Face
MOGS	Endocrine/Metabolic
AGPS	Skeleton
OFD1	Kidney Renal Tract
PAFAH1B1	Brain/Cognition
COL1A1	Skeleton
CAMTA1	Brain/Cognition
CHST3	Skeleton
HRAS	Skin
RPGRIP1	Eye
RIPK4	Skeleton
BRIP1	Bone Marrow/Immune
TBX3	Musculature
LAMA1	Brain/Cognition
ERLIN2	Brain/Cognition
PCCA	Endocrine/Metabolic
FKRP	Musculature
COX15	Musculature
COG7	Endocrine/Metabolic
SCN2A	Brain/Cognition
MECP2	Brain/Cognition
BRAF	Skin
FTL	Endocrine/Metabolic
CBL	Skin
POMGNT1	Musculature
COL2A1	Face
TGFB3	Face
PIGO	Endocrine/Metabolic
GJA1	Teeth & Dentitian
PLK4	Brain/Cognition
ARSA	Endocrine/Metabolic
CLN3	Endocrine/Metabolic
LRP5	Skeleton
FOXP2	Brain/Cognition
DOCK6	Skin
SLC6A3	Brain/Cognition
PITX3	Eye
CHAMP1	Brain/Cognition
XPC	Bone Marrow/Immune
FOXE3	Eye
SUMO1	Face
STAT1	Bone Marrow/Immune
CLN8	Endocrine/Metabolic
RTEL1	Bone Marrow/Immune
GDF3	Skeleton
MKKS	Kidney Renal Tract
NPHS1	Kidney Renal Tract
ACAN	Skeleton
GJA8	Eye
LRPAP1	Eye
NAGA	Endocrine/Metabolic
PLCB1	Brain/Cognition
NT5C3A	Bone Marrow/Immune
SLC4A11	Eye
ARX	Brain/Cognition
SMARCA2	Skin
IQSEC2	Brain/Cognition
VSX2	Eye
NSDHL	Skin
DPAGT1	Endocrine/Metabolic
KBTBD13	Musculature
SOX9	Face
AMER1	Face
PLCB4	Face
LGI1	Brain/Cognition
NEK8	Kidney Renal Tract
LDB3	Musculature
TRAPPC2	Skeleton
HOXC13	Hair/Nails
CDC6	Skeleton
IFT140	Kidney Renal Tract
PIGV	Endocrine/Metabolic
MSX1	Face
MAGEL2	Brain/Cognition
STIM1	Musculature
SLC2A1	Brain/Cognition
GRHL2	Skin
HADH	Endocrine/Metabolic
PRRT2	Brain/Cognition
GDF5	Skeleton
OTC	Endocrine/Metabolic
EXPH5	Skin
ZEB1	Eye
CRYBB2	Eye
STAT5B	Endocrine/Metabolic
SALL1	Kidney Renal Tract
PDE6G	Eye
JAM3	Brain/Cognition
NALCN	Skeleton
FOXN1	Bone Marrow/Immune
ATP7A	Skin
BBS10	Skeleton
MTO1	Endocrine/Metabolic
FTO	Skeleton
GBA	Bone Marrow/Immune
XYLT1	Skeleton
CHRNG	Musculature
CHSY1	Skeleton
POMT2	Musculature
NOG	Skeleton
KIF1BP	Brain/Cognition
IFT172	Kidney Renal Tract
CC2D2A	Kidney Renal Tract
INPP5E	Brain/Cognition
CACNA1D	Endocrine/Metabolic
SATB2	Face
GATA6	Heart/Cardiovasculature/Lymphatic
DOCK8	Bone Marrow/Immune
SLC46A1	Bone Marrow/Immune
DMPK	Musculature
AGA	Skeleton
CSTA	Skin
SLC25A38	Bone Marrow/Immune
COL11A2	Face
DLX5	Skeleton
BRCA1	Brain/Cognition
ABCC6	Heart/Cardiovasculature/Lymphatic
AFF2	Brain/Cognition
MRPS22	Face
HOXA1	Brain/Cognition
KCNE1	Ear
GPSM2	Brain/Cognition
ACTB	Brain/Cognition
PXDN	Eye
AFG3L2	Brain/Cognition
EBP	Skeleton
PSMB8	Bone Marrow/Immune
ASCC3	Brain/Cognition
LAMC3	Brain/Cognition
PITX2	Teeth & Dentitian
XRCC4	Endocrine/Metabolic
PEX13	Kidney Renal Tract
MAT1A	Endocrine/Metabolic
SCN11A	Spinal cord/Peripheral nerves
COL9A1	Face
NKX2-5	Heart/Cardiovasculature/Lymphatic
CRB1	Eye
TCF4	Face
GFM1	Endocrine/Metabolic
TUBA8	Brain/Cognition
IGF2	Endocrine
FGFR2	Face
BBS4	Skeleton
SLC24A4	Teeth & Dentitian
PCNT	Bone Marrow/Immune
BUB1B	Skeleton
EYA1	Kidney Renal Tract
NAGS	Endocrine/Metabolic
SNAP29	Skin
TBX1	Bone Marrow/Immune
RPS6KA3	Face
SLC25A15	Endocrine/Metabolic
PYGL	GI tract
BRAT1	Brain/Cognition
RFT1	Endocrine/Metabolic
ALDH18A1	Skin
PYCR1	Skin
GDI1	Brain/Cognition
COQ2	Endocrine/Metabolic
GLDC	Endocrine/Metabolic
TBL1XR1	Brain/Cognition
L1CAM	Brain/Cognition
NOP10	Bone Marrow/Immune
MPDU1	Endocrine/Metabolic
TCTN2	Kidney Renal Tract
PLEC	Musculature
TCTN1	Brain/Cognition
SLC4A1	Kidney Renal Tract
FANCC	Bone Marrow/Immune
CNTNAP2	Brain/Cognition
SMARCE1	Skeleton
MRE11	Brain/Cognition
RABL6	Brain/Cognition
DDB2	Skin
FAT4	Brain/Cognition
PIK3R1	Skeleton
VPS13B	Teeth & Dentitian
ERCC3	Skin
SMPD1	Endocrine/Metabolic
WNT4	Brain/Cognition
GLUD1	Endocrine/Metabolic
B3GALT6	Skin
HADHA	Endocrine/Metabolic
DDHD1	Brain/Cognition
SLC52A3	Brain/Cognition
FRY	Brain/Cognition
HUWE1	Skeleton
DYNC1H1	Brain/Cognition
MEGF10	Musculature
ARL14EP	Brain/Cognition
ADGRG1	Brain/Cognition
MPLKIP	Skin
WT1	Kidney Renal Tract
RECQL4	Bone Marrow/Immune
CHRDL1	Eye
DVL1	Face
CNKSR1	Brain/Cognition
DSTYK	Kidney Renal Tract
TMEM114	Eye
ALG8	Endocrine/Metabolic
MASP1	Face
ROR2	Skeleton
KCNC3	Brain/Cognition
NDP	Brain/Cognition
KAT6A	Brain/Cognition
BCOR	Skeleton
ADAMTS18	Skin
HDAC8	Skeleton
PDSS1	Endocrine/Metabolic
FREM2	Skin
HSPG2	Musculature
ALG1	Endocrine/Metabolic
AUTS2	Brain/Cognition
RARS2	Brain/Cognition
POLD1	Skin
LRAT	Brain/Cognition
KARS	Spinal cord/Peripheral nerves
GNPTAB	Skeleton
SLC35C1	Bone Marrow/Immune
SATB2	Face
SNX3	Face
NDUFS8	Endocrine/Metabolic
PHC1	Brain/Cognition
SCN4A	Musculature
KRIT1	Skin
ALG11	Endocrine/Metabolic
PEX5	Kidney Renal Tract
GDF1	Heart/Cardiovasculature/Lymphatic
HESX1	Endocrine
TRMT1	Brain/Cognition
WDR60	Skeleton
IKBKG	Bone Marrow/Immune
DLL3	Skeleton
RASA1	Skeleton
FANCF	Bone Marrow/Immune
FH	Kidney Renal Tract
MYO7A	Eye
RUNX2	Teeth & Dentitian
CRYGC	Eye
OCRL	Skin
RFX6	Endocrine/Metabolic
LRPPRC	Endocrine/Metabolic
NUP62	Brain/Cognition
NPR2	Skeleton
PET100	Endocrine/Metabolic
SRCAP	Skeleton
COASY	Brain/Cognition
NPHP4	Kidney Renal Tract
PRRX1	Face
EVC	Teeth & Dentitian
SCN1A	Brain/Cognition
ZFYVE26	Brain/Cognition
PARP1	Brain/Cognition
DEAF1	Brain/Cognition
WDR35	Skeleton
SCAPER	Brain/Cognition
ELN	Skin
RNASEH2A	Skin
GJB3	Skin
AP4M1	Brain/Cognition
NR2F2	Heart/Cardiovasculature/Lymphatic
C12orf57	Brain/Cognition
SMARCB1	Musculature
MOCS1	Endocrine/Metabolic
PAX6	Brain/Cognition
DLAT	Endocrine/Metabolic
SH3PXD2B	Skeleton
NR2F1	Brain/Cognition
SRPX2	Brain/Cognition
KAT6B	Skeleton
GLI3	Endocrine
RETREG1	Spinal cord/Peripheral nerves
PIP5K1C	Skeleton
PAH	Skin
TGFBR1	Face
FKTN	Musculature
LMNA	Musculature
GHR	Endocrine/Metabolic
COQ4	Endocrine/Metabolic
PAX9	Teeth & Dentitian
FHL1	Musculature
CDH23	Eye
TRPM1	Eye
AP1S2	Brain/Cognition
STS	Skin
ALPL	Skeleton
GLI2	Brain/Cognition
ASAH1	Skin
MMAA	Multisystem
PEX14	Endocrine/Metabolic
PGAP2	Skeleton
STRA6	Brain/Cognition
ZNF711	Brain/Cognition
PRSS12	Brain/Cognition
MYH3	Musculature
HCCS	Skin
STAMBP	Skin
NKX3-2	Skeleton
NSUN2	Brain/Cognition
TGFBR2	Face
PEX16	Skeleton
ITCH	Bone Marrow/Immune
DPM3	Face
DDC	Endocrine/Metabolic
NFU1	Endocrine/Metabolic
DEPDC5	Brain/Cognition
SYT1	Brain/Cognition
PIK3CA	Skeleton
DHODH	Face
PRPS1	Spinal cord/Peripheral nerves
GLB1	Endocrine/Metabolic
DMP1	Skeleton
RAX	Brain/Cognition
SLC25A19	Endocrine/Metabolic
B3GALNT2	Musculature
ARHGAP31	Skin
BBS5	Skeleton
PECR	Brain/Cognition
MPDZ	Brain/Cognition
DHTKD1	Endocrine/Metabolic
ABCB6	Eye
SLC6A1	Brain/Cognition
HSPD1	Brain/Cognition
ANO5	Musculature
GAMT	Endocrine/Metabolic
SLC2A10	Heart/Cardiovasculature/Lymphatic
CFC1	Heart/Cardiovasculature/Lymphatic
PLOD3	Skin
ARID1B	Skin
PLXND1	Spinal cord/Peripheral nerves
PLCG2	Bone Marrow/Immune
SHROOM3	Skeleton
VRK1	Brain/Cognition
WWOX	Spinal cord/Peripheral nerves
AGL	Endocrine/Metabolic
TRPS1	Skin
BMP4	Face
KLHL40	Musculature
LRP2	Brain/Cognition
MGAT2	Bone Marrow/Immune
SOX11	Brain/Cognition
ATP13A2	Brain/Cognition
RELN	Brain/Cognition
GALT	Endocrine/Metabolic
UGT1A1	Endocrine/Metabolic
LYST	Bone Marrow/Immune
ZEB2	Face
TTC8	Kidney Renal Tract
PRKAR1A	Skeleton
IFT43	Skin
FLVCR2	Brain/Cognition
CYP2U1	Brain/Cognition
ANTXR1	Teeth & Dentitian
NPHS2	Kidney Renal Tract
HOXD13	Skeleton
EHMT1	Face
CDT1	Skeleton
TTN	Musculature
FBLN1	Skeleton
PTPRF	Skin
SLC13A5	Teeth & Dentitian
ERCC6	Skeleton
MANBA	Spinal cord/Peripheral nerves
PTDSS1	Face
ARHGEF9	Brain/Cognition
RSPO4	Skin
SLC25A20	Endocrine/Metabolic
WNT10B	Skeleton
PEX1	Kidney Renal Tract
TREX1	Skin
KCNA2	Brain/Cognition
RAD21	Face
SZT2	Brain/Cognition
HPD	Endocrine/Metabolic
GNPAT	Skin
DNM1	Brain/Cognition
COG5	Endocrine/Metabolic
HEXB	Endocrine/Metabolic
MED13L	Brain/Cognition
MESP2	Skeleton
CDK5RAP2	Brain/Cognition
CTNS	Kidney Renal Tract
PCBD1	Endocrine/Metabolic
TEK	Skin
BCAP31	Brain/Cognition
MYH6	Heart/Cardiovasculature/Lymphatic
HSD17B4	Brain/Cognition
KANK1	Brain/Cognition
ANKRD11	Teeth & Dentitian
PHF21A	Brain/Cognition
VANGL1	Skeleton
NF1	Skin
BPIFB6	Brain/Cognition
PTF1A	Endocrine/Metabolic
ASCL1	Brain/Cognition
FLG	Skin
PIGQ	Brain/Cognition
WNT7A	Skeleton
FOXL2	Eye
CFL2	Musculature
MED17	Brain/Cognition
SMARCA4	Skeleton
SLC5A5	Endocrine/Metabolic
ACTA2	Heart/Cardiovasculature/Lymphatic
FANCG	Bone Marrow/Immune
FBXW4	Skeleton
ASPH	Face
TUBB2A	Brain/Cognition
SUMF1	Endocrine/Metabolic
PEX6	Kidney Renal Tract
CIB2	Eye
RNF135	Skeleton
PDCD10	Brain/Cognition
C2CD3	Face
CEP41	Brain/Cognition
HCN1	Brain/Cognition
TGFB1	Skeleton
PTEN	Skin
FGFR1	Face
SGSH	Bone Marrow/Immune
TLL1	Heart/Cardiovasculature/Lymphatic
GRIK2	Brain/Cognition
ORC1	Skeleton
FANCE	Bone Marrow/Immune
SYNE1	Brain/Cognition
ARL6	Skeleton
QKI	Brain/Cognition
IDUA	Skeleton
STXBP1	Brain/Cognition
DNMT3A	Endocrine/Metabolic
UVSSA	Bone Marrow/Immune
PTPN14	Face
ROBO3	Skeleton
BBS1	Skeleton
ALX1	Face
WNT3	Skeleton
MT-TP	Bone Marrow/Immune
ALG12	Skeleton
OXCT1	Endocrine/Metabolic
NFIX	Skeleton
MFSD8	Brain/Cognition
ERCC2	Skin
PDSS2	Kidney Renal Tract
GUSB	Face
HSD17B10	Endocrine/Metabolic
RET	Kidney Renal Tract
RIT1	Face
ZFP57	Endocrine/Metabolic
ZMPSTE24	Skin
ERCC4	Bone Marrow/Immune
TAC3	Endocrine/Metabolic
PEX26	Kidney Renal Tract
DARS2	Endocrine/Metabolic
MLYCD	Endocrine/Metabolic
KIT	GI tract
RBM28	Skin
HGSNAT	Endocrine/Metabolic
GCDH	Endocrine/Metabolic
PIGL	Multisystem
ZFPM2	GI tract
DNAAF4	Respiratory tract
AMPD2	Brain/Cognition
ABCC9	Skin
CLPP	Ear
KDM6A	Kidney Renal Tract
ASPM	Brain/Cognition
SHOX	Skeleton
GDF6	Skeleton
TMEM67	Kidney Renal Tract
ZIC3	Skeleton
ACVR2B	GI tract
KCNC1	Brain/Cognition
CHRNB2	Brain/Cognition
MITF	Skin
MMADHC	Bone Marrow/Immune
GALK1	Endocrine/Metabolic
NYX	Eye
CRB2	Kidney Renal Tract
PC	Endocrine/Metabolic
TMEM237	Brain/Cognition
PEX12	Skeleton
CCDC78	Musculature
GATA4	Heart/Cardiovasculature/Lymphatic
SCN8A	Brain/Cognition
TMEM5	Brain/Cognition
GABRB3	Brain/Cognition
CRYAB	Musculature
FOXF1	Respiratory tract
SOX2	Endocrine/Metabolic
SURF1	Endocrine/Metabolic
GRIN2B	Brain/Cognition
KIF11	Brain/Cognition
CTCF	Brain/Cognition
EXT2	Skeleton
TSEN34	Brain/Cognition
RPGRIP1L	Kidney Renal Tract
ABCD4	Endocrine/Metabolic
OPHN1	Face
GJB2	Skin
ZDHHC15	Brain/Cognition
ACADM	Endocrine/Metabolic
MYO5A	Skin
SMAD3	Skeleton
TACR3	Endocrine/Metabolic
LRRC6	Respiratory tract
CASK	Face
ETFDH	Endocrine/Metabolic
TFAP2B	Face
DDX3X	Brain/Cognition
AR	Endocrine/Metabolic
TRPV3	Skin
SALL4	Kidney Renal Tract
GRHL3	Face
IRF6	Face
ARFGEF2	Brain/Cognition
HYLS1	Face
SACS	Brain/Cognition
BANF1	Skin
NR1I3	Brain/Cognition
ZDHHC9	Brain/Cognition
DYM	Skeleton
FOXC1	Eye
KCNMA1	Brain/Cognition
NDUFV1	Endocrine/Metabolic
DOLK	Endocrine/Metabolic
ATRX	Face
IFT122	Skin
SLC6A5	Brain/Cognition
WDR19	Kidney Renal Tract
CEP152	Face
DSPP	Teeth & Dentitian
CLCN7	Skeleton
OTOGL	Ear
PTHLH	Skeleton
TBC1D24	Skeleton
MAFB	Skeleton
C12orf65	Endocrine/Metabolic
PKHD1	Kidney Renal Tract
DCX	Brain/Cognition
FAM111A	Skeleton
MPI	Endocrine/Metabolic
POC1B	Eye
MCCC2	Endocrine/Metabolic
PDHA1	Endocrine/Metabolic
CRX	Eye
CRYAA	Eye
GJC2	Brain/Cognition
NRXN2	Brain/Cognition
JAGN1	Bone Marrow/Immune
PMM2	Endocrine/Metabolic
SOX10	Skin
UMPS	Bone Marrow/Immune
PEX19	Kidney Renal Tract
SLC4A4	Kidney Renal Tract
FOXE1	Face
BLOC1S6	Skin
DSG1	Bone Marrow/Immune
SPTAN1	Brain/Cognition
ABCB11	GI tract
GNAO1	Brain/Cognition
ALAD	Endocrine/Metabolic
LEMD3	Skeleton
FLVCR1	Brain/Cognition
TMEM216	Brain/Cognition
THRA	Endocrine
CLCNKB	Kidney Renal Tract
BFSP2	Eye
TUBGCP6	Brain/Cognition
RRAS	Skeleton
NECTIN4	Skin
FRMD7	Brain/Cognition
GLUL	Endocrine/Metabolic
ORC4	Skeleton
COLEC11	Face
CRYGD	Eye
CHD7	Skeleton
NEDD4L	Brain/Cognition
ZIC2	Brain/Cognition
GRIN2A	Brain/Cognition
FMR1	Brain/Cognition
TBC1D24	Brain/Cognition
NFIA	Kidney Renal Tract
WDR45	Brain/Cognition
TECPR2	Brain/Cognition
NEU1	Skeleton
QARS	Brain/Cognition
CDH3	Skin
PAX3	Face
NKX2-1	Endocrine/Metabolic
SNRPB	Face
CTSA	Skeleton
GON4L	Brain/Cognition
BMPER	Skeleton
SLC19A3	Endocrine/Metabolic
SOX17	Kidney Renal Tract
ARHGEF6	Brain/Cognition
BCL11A	Brain/Cognition
GNAS	Skeleton
GNS	Skeleton
WWOX	Brain/Cognition
CRYBB1	Eye
SLC6A8	Face
PHGDH	Endocrine/Metabolic
MTF1	Brain/Cognition
ALDH5A1	Endocrine/Metabolic
PEX7	Face
NDUFS4	Endocrine/Metabolic
COL4A1	Brain/Cognition
POMT1	Musculature
NRXN3	Brain/Cognition
C8orf37	Eye
CAV1	Skin
SLC39A13	Skin
CEP63	Skeleton
BICD2	Spinal cord/Peripheral nerves
KRT74	Skin
B4GALT7	Skeleton
EEF1B2	Brain/Cognition
RUBCN	Brain/Cognition
DHFR	Bone Marrow/Immune
HARS	Eye
CA2	Kidney Renal Tract
GCSH	Endocrine/Metabolic
CHUK	Skin
HSF4	Eye
RAD51	Brain/Cognition
GALC	Brain/Cognition
RNASEH2B	Skin
ACOX1	Endocrine/Metabolic
CACNA1A	Brain/Cognition
CDH15	Brain/Cognition
MIR17HG	Skeleton
DHCR24	Face
ZBTB16	Skeleton
GFAP	Brain/Cognition
MAP2K1	Skin
TBCE	Bone Marrow/Immune
SLC25A22	Brain/Cognition
NRXN1	Brain/Cognition
JAG1	GI tract
SOX3	Endocrine/Metabolic
TIMM8A	Musculature
SCARF2	Skin
DCAF17	Skin
MTRR	Bone Marrow/Immune
TP63	Skin
RALGDS	Brain/Cognition
ALG13	Brain/Cognition
LAMA2	Musculature
PLP1	Brain/Cognition
PTS	Endocrine/Metabolic
COL10A1	Skeleton
FBN2	Skeleton
AAAS	Face
KLF8	Brain/Cognition
IMPAD1	Skeleton
USP9X	Skeleton
DNAAF3	Respiratory tract
SLC6A17	Brain/Cognition
DNMT3B	Bone Marrow/Immune
SMC3	Skeleton
SMOC1	Face
SLC2A2	Kidney Renal Tract
DNA2	Endocrine/Metabolic
LRP2	Kidney Renal Tract
ZNF526	Brain/Cognition
ESCO2	Face
CCBE1	Face
DYNC2H1	Kidney Renal Tract
RNU4ATAC	Skeleton
RAPSN	Musculature
POGZ	Brain/Cognition
CD151	Skin
TUBA1A	Brain/Cognition
ACADS	Endocrine/Metabolic
ADSL	Endocrine/Metabolic
NR5A1	Genitalia
COG1	Endocrine/Metabolic
ELOVL4	Skin
NDST1	Brain/Cognition
FMN2	Brain/Cognition
TUBB	Brain/Cognition
ZC4H2	Musculature
CLN6	Brain/Cognition
SHANK3	Brain/Cognition
CLDN19	Endocrine/Metabolic
ALS2	Spinal cord/Peripheral nerves
SHH	Teeth & Dentitian
ADRA2B	Brain/Cognition
BOLA3	Endocrine/Metabolic
TCF12	Face
TAT	Skin
TTC19	Endocrine/Metabolic
PURA	Brain/Cognition
SLC12A5	Brain/Cognition
MNX1	Skeleton
ADA	Bone Marrow/Immune
AASS	Endocrine/Metabolic
TFAP2A	Skin
TBXAS1	Bone Marrow/Immune
LHX4	Endocrine/Metabolic
FANCL	Bone Marrow/Immune
EDA	Teeth & Dentitian
MED23	Brain/Cognition
COL11A1	Skeleton
ATP1A3	Brain/Cognition
SLC22A5	Endocrine/Metabolic
AIFM1	Endocrine/Metabolic
KCNJ11	Endocrine/Metabolic
PSPH	Endocrine/Metabolic
UBE2A	Brain/Cognition
FZD6	Skin
CEP135	Brain/Cognition
FGF3	Teeth & Dentitian
ISPD	Brain/Cognition
FAM58A	Kidney Renal Tract
WRAP53	Bone Marrow/Immune
MAP3K1	Genitalia
KRAS	Skin
CACNB4	Brain/Cognition
TBX5	Skeleton
MKS1	Kidney Renal Tract
CRYBA4	Eye
COL9A2	Face
PEX3	Kidney Renal Tract
LRBA	Bone Marrow/Immune
KIF5C	Brain/Cognition
EXOSC3	Spinal cord/Peripheral nerves
FANCD2	Bone Marrow/Immune
AUH	Endocrine/Metabolic
PEX2	Kidney Renal Tract
EXT1	Skin
DBT	Endocrine/Metabolic
BCKDHA	Endocrine/Metabolic
SLC35A1	Endocrine/Metabolic
QDPR	Endocrine/Metabolic
KMT2D	Kidney Renal Tract
HINT1	Musculature
UBR1	Face
AIRE	Endocrine/Metabolic
ALG6	Endocrine/Metabolic
YY1	Brain/Cognition
SLC17A5	Endocrine/Metabolic
ARID1A	Skin
MED12	Skeleton
ACBD6	Brain/Cognition
SRY	Genitalia
CRYBA1	Eye
SCN1B	Brain/Cognition
HIST3H3	Brain/Cognition
RAI1	Face
CD96	Skeleton
CSNK1G1	Brain/Cognition
TUBB3	Brain/Cognition
SETD5	Brain/Cognition
DDHD2	Brain/Cognition
CCDC151	GI tract
KCNJ6	Skin
TUBGCP4	Brain/Cognition
MMP13	Skeleton
RPS19	Bone Marrow/Immune
GAA	Endocrine/Metabolic
KIRREL3	Brain/Cognition
CHRNA2	Brain/Cognition
PTH1R	Skeleton
PIK3R2	Brain/Cognition
KCTD1	Skin
ATOH7	Eye
GFER	Musculature
TBX20	Heart/Cardiovasculature/Lymphatic
TMEM165	Skeleton
FAM126A	Brain/Cognition
HNF1B	Skeleton
ELP2	Brain/Cognition
MOCS2	Endocrine/Metabolic
SYNGAP1	Brain/Cognition
HR	Skin
ANKRD26	Bone Marrow/Immune
ALDOB	Endocrine/Metabolic
SLC12A6	Face
SLC35A2	Endocrine/Metabolic
ABCD1	Endocrine/Metabolic
SMS	Face
FTCD	Bone Marrow/Immune
KCNQ2	Musculature
ASPA	Endocrine/Metabolic
ZNF750	Skin
EP300	Face
UPF3B	Skeleton
SAMHD1	Skin
ASL	Endocrine/Metabolic
STX1B	Brain/Cognition
SLC26A2	Skeleton
GABRA1	Brain/Cognition
MYH8	Skin
SIX5	Skin
COQ9	Endocrine/Metabolic
PPT1	Endocrine/Metabolic
SLC9A6	Brain/Cognition
BRCA2	Bone Marrow/Immune
CENPJ	Face
MICU1	Musculature
NDUFS1	Endocrine/Metabolic
AARS	Brain/Cognition
EPG5	Musculature
ADK	Brain/Cognition
LRP4	Skeleton
SIX1	Kidney Renal Tract
SETBP1	Face
PNPLA2	Musculature
WDR34	Skeleton
AP4B1	Brain/Cognition
CLP1	Brain/Cognition
HOXB1	Face
MAGI2	Brain/Cognition
ETFA	Endocrine/Metabolic
CHMP1A	Brain/Cognition
COQ5	Brain/Cognition
NECTIN1	Skin
NOTCH1	Heart/Cardiovasculature/Lymphatic
CBS	Skeleton
PNPLA1	Skin
PIGA	Brain/Cognition
NIPBL	Bone Marrow/Immune
KCNQ1	Ear
C2orf71	Eye
KCNK9	Face
WNT1	Skeleton
SIK1	Brain/Cognition
CA8	Brain/Cognition
ELAC2	Endocrine/Metabolic
PTPN11	Skeleton
TWIST1	Skeleton
EOGT	Skin
GUCY2C	GI tract
OBSL1	Skeleton
RARB	Brain/Cognition
MMAB	Endocrine/Metabolic
RAB39B	Brain/Cognition
AXIN1	Skeleton
MTHFR	Endocrine/Metabolic
LARS2	Ear
HMGCL	Endocrine/Metabolic
ALDOA	Musculature
NAGLU	Skeleton
WDR73	Kidney Renal Tract
PDHX	Endocrine/Metabolic
NOTCH2	Kidney Renal Tract
TNFRSF13B	Bone Marrow/Immune
PEX10	Kidney Renal Tract
ARSB	Skeleton
PCGF2	Brain/Cognition
RMND1	Endocrine/Metabolic
NHS	Teeth & Dentitian
COX7B	Skin
PEPD	Bone Marrow/Immune
NGLY1	Endocrine/Metabolic
SC5D	Endocrine/Metabolic
ECEL1	Skeleton
ALMS1	Endocrine/Metabolic
GATAD2B	Brain/Cognition
ARMC4	Respiratory tract
RYR1	Musculature
FGF10	Teeth & Dentitian
KCNT1	Brain/Cognition
ABHD5	Bone Marrow/Immune
MATN3	Skeleton
FAR1	Endocrine/Metabolic
NDUFS7	Endocrine/Metabolic
GMPPB	Musculature
CYC1	Endocrine/Metabolic
P4HB	Face
ANKH	Skeleton
WDR45B	Brain/Cognition
ACO2	Endocrine/Metabolic
GNPTG	Skeleton
TTC7A	Bone Marrow/Immune
RGS7	Brain/Cognition
PGK1	Bone Marrow/Immune
CLCNKA	Kidney Renal Tract
FANCA	Bone Marrow/Immune
LEFTY2	GI tract
FAM20A	Teeth & Dentitian
ACY1	Endocrine/Metabolic
PROP1	Endocrine/Metabolic
GTPBP3	Musculature
PTCHD1	Brain/Cognition
ACSL4	Face
ITGA3	Skin
AGTR2	Brain/Cognition
DDR2	Skeleton
LARGE1	Musculature
MYO5B	GI tract
ZBTB40	Brain/Cognition
SLC16A2	Endocrine/Metabolic
BHLHA9	Skeleton
HPRT1	Endocrine/Metabolic
ZMYND10	Respiratory tract
KCNH5	Brain/Cognition
ASXL3	Face
KCTD7	Brain/Cognition
DAG1	Musculature
ABCB7	Bone Marrow/Immune
CTC1	Brain/Cognition
CLMP	GI tract
FAH	Kidney Renal Tract
SMC1A	Skeleton
COMP	Skeleton
CHST14	Skin
CRYBB3	Eye
IHH	Skeleton
CDON	Brain/Cognition
FUCA1	Skeleton
CACNA1C	Skeleton
TRIP11	Skeleton
COL4A3	Kidney Renal Tract
IDS	Skeleton
SPRED1	Skin
TGIF1	Brain/Cognition
BCS1L	Skeleton
AIPL1	Eye
PHF6	Face
CCDC114	Respiratory tract
KIF1A	Peripheral nerves
FAM20C	Skeleton
GRM6	Eye
SNRPE	Hair/Nails
RAF1	Skin
KIF1A	Peripheral nerves
SRD5A3	Endocrine/Metabolic
IGF1R	Endocrine/Metabolic
IARS2	Endocrine/Metabolic
CAPN10	Brain/Cognition
FAM161A	Eye
MID1	Face
PNPT1	Ear
PLCE1	Kidney Renal Tract
VLDLR	Skeleton
MEF2C	Face
SOBP	Face
MSX2	Skeleton
ZNF599	Brain/Cognition
NLGN4X	Brain/Cognition
ALDH7A1	Brain/Cognition
NMNAT1	Eye
TUBB4A	Brain/Cognition
AK2	Bone Marrow/Immune
HSD3B7	Endocrine/Metabolic
EGR2	Spinal cord/Peripheral nerves
ZMYM6	Brain/Cognition
SIX6	Eye
IGSF1	Endocrine/Metabolic
ERCC6L2	Bone Marrow/Immune
CEP57	Bone Marrow/Immune
HPSE2	Kidney Renal Tract
NLGN3	Brain/Cognition
IRX5	Bone Marrow/Immune
KIF7	Brain/Cognition
LMBRD1	Skeleton
RMRP	Skeleton
LAMP2	Musculature
GAD1	Brain/Cognition
HNF4A	Kidney Renal Tract
LTBP2	Eye
MAPK10	Brain/Cognition
OTX2	Endocrine/Metabolic
UQCRQ	Endocrine/Metabolic
DIP2B	Brain/Cognition
GATA2	Bone Marrow/Immune
SDHAF1	Endocrine/Metabolic
FBN1	Skeleton
ATP8B1	Endocrine/Metabolic
FIG4	Skeleton
SECISBP2	Endocrine
MTMR14	Musculature
MAN2B1	Bone Marrow/Immune
RAD51C	Bone Marrow/Immune
FOXG1	Brain/Cognition
CCNA2	Brain/Cognition
TWIST2	Skin
ADNP	Brain/Cognition
NDUFAF2	Endocrine/Metabolic
IGBP1	Face
GCH1	Endocrine/Metabolic
TRPV4	Skeleton
LIG4	Bone Marrow/Immune
COA5	Endocrine/Metabolic
COL25A1	Spinal cord/Peripheral nerves
POLR1C	Face
KCNH1	Skeleton
IFIH1	Bone Marrow/Immune
SIX3	Brain/Cognition
CHRNA4	Brain/Cognition
PCDH19	Brain/Cognition
TBX4	Skeleton
HEXA	Endocrine/Metabolic
ATP6V1B1	Kidney Renal Tract
RSPH1	Respiratory tract
SMAD4	Skeleton
C5orf42	Brain/Cognition
ALX4	Face
SCO2	Endocrine/Metabolic
MAF	Face
CCNO	Respiratory tract
WDPCP	Kidney Renal Tract
ALX3	Face
FREM1	Skin
CKAP2L	Face
UBE3A	Face
POLR3B	Teeth & Dentitian
SEC23A	Skeleton
WNT5A	Face
MAMLD1	Genitalia
STT3A	Brain/Cognition
UBE3B	Skin
JAK3	Bone Marrow/Immune
AP4S1	Brain/Cognition
COX10	Musculature
ALG3	Endocrine/Metabolic
KIF2A	Brain/Cognition
NDE1	Brain/Cognition
KANSL1	Brain/Cognition
WDR11	Endocrine
ALDH1A3	Brain/Cognition
THAP1	Brain/Cognition
SOS1	Skin
HAX1	Bone Marrow/Immune
COX14	Endocrine/Metabolic
ITGA7	Musculature
TSPAN7	Brain/Cognition
MYOC	Eye
CASP2	Brain/Cognition
MBD5	Brain/Cognition
RPE65	Eye
CUL4B	Brain/Cognition
TMCO1	Face
AKT3	Brain/Cognition
FOLR1	Endocrine/Metabolic
PAPSS2	Skeleton
TRIO	Brain/Cognition
ASH1L	Brain/Cognition
SDHA	Endocrine/Metabolic
TSHR	Endocrine/Metabolic
COL9A3	Musculature
GRIA3	Brain/Cognition
PHIP	Brain/Cognition
ERCC5	Skin
TSC2	Skin
NPHP1	Kidney Renal Tract
VDR	Skeleton
PRSS56	Eye
TUFM	Endocrine/Metabolic
GRIN1	Brain/Cognition
PIGT	Skeleton
MIR184	Eye
SPG11	Brain/Cognition
TYRP1	Skin
PAK3	Brain/Cognition
CSPP1	Skeleton
EMX2	Brain/Cognition
ALG2	Endocrine/Metabolic
TACO1	Endocrine/Metabolic
TUBB3	Brain/Cognition
CCND2	Skeleton
TTC37	Skin
P3H1	Skeleton
GNAI3	Face
ALDH4A1	Endocrine/Metabolic
RBPJ	Skin
GPR179	Eye
MTM1	Musculature
ERBB3	Skeleton
CTDP1	Musculature
LFNG	Skeleton
EVC2	Teeth & Dentitian
CA5A	Endocrine/Metabolic
MAN1B1	Brain/Cognition
LONP1	Skeleton
NSMCE3	Respiratory tract
CRELD1	GI tract
ACAD9	Endocrine/Metabolic
SPR	Brain/Cognition
GABBR2	Brain/Cognition
SMOC2	Teeth & Dentitian
MCEE	Multisystem
CNKSR2	Brain/Cognition
EDN1	Face
ATIC	Endocrine/Metabolic
AP4E1	Brain/Cognition
ERMARD	Brain/Cognition
KPTN	Brain/Cognition
CPS1	Endocrine/Metabolic
INPPL1	Skeleton
MC2R	Endocrine/Metabolic
DYRK1A	Face
ACTA1	Musculature
PREPL	Kidney Renal Tract
DDX58	Teeth & Dentitian
DECR1	Endocrine/Metabolic
POMGNT2	Brain/Cognition
TM4SF20	Brain/Cognition
COL4A3BP	Brain/Cognition
AKT1	Skin
PITX1	Skeleton
LAMB1	Brain/Cognition
BCKDHB	Endocrine/Metabolic
TAZ	Endocrine/Metabolic
MTR	Bone Marrow/Immune
MYCN	Skeleton
ACP5	Bone Marrow/Immune
FTSJ1	Brain/Cognition
GBA2	Brain/Cognition
IL1RAPL1	Brain/Cognition
ST3GAL5	Brain/Cognition
RBM8A	Bone Marrow/Immune
SRGAP3	Brain/Cognition
KCNJ10	Endocrine/Metabolic
PLOD2	Skeleton
FANCM	Bone Marrow/Immune
COL18A1	Skin
COG4	Endocrine/Metabolic
TYR	Skin
IGHMBP2	Musculature
KLF1	Bone Marrow/Immune
MLC1	Brain/Cognition
TGFB2	Heart/Cardiovasculature/Lymphatic
DNAAF5	Respiratory tract
RYR3	Brain/Cognition
TRAPPC11	Musculature
SPEG	Musculature
HIBCH	Endocrine/Metabolic
SCO1	Musculature
LHX3	Skeleton
NHP2	Skin
UROS	Skin
SHANK2	Brain/Cognition
NEB	Musculature
L2HGDH	Endocrine/Metabolic
FGF9	Skeleton
RAB3GAP2	Brain/Cognition
TGDS	Face
LBR	Bone Marrow/Immune
SEC23B	Bone Marrow/Immune
MTOR	Face
HOXA13	Skeleton
SLC27A4	Skin
ALDH3A2	Brain/Cognition
TBX22	Face
HPS1	Bone Marrow/Immune
GK	Endocrine/Metabolic
TUBB2B	Brain/Cognition
CCDC103	Lungs
STT3B	Endocrine/Metabolic
CLPB	Bone Marrow/Immune
DMD	Musculature
RBM10	Face
EFTUD2	Face
FASN	Brain/Cognition
APTX	Spinal cord/Peripheral nerves
MCCC1	Endocrine/Metabolic
SLC35D1	Skeleton
PMS2	GI tract
TAB2	Heart/Cardiovasculature/Lymphatic
LTBP3	Teeth & Dentitian
ZCCHC8	Brain/Cognition
KDM6B	Brain/Cognition
IFT80	Skeleton
FKBP14	Musculature
FOXC2	Eye
LINS1	Brain/Cognition
DLD	Endocrine/Metabolic
PAX8	Endocrine/Metabolic
ENPP1	Heart/Cardiovasculature/Lymphatic
PDE4D	Skeleton
TRAPPC9	Brain/Cognition
CTNNB1	Brain/Cognition
ZNF713	Brain/Cognition
KDM5C	Face
FLT4	Heart/Cardiovasculature/Lymphatic
SMAD2	Heart/Cardiovasculature/Lymphatic
CACNA1G	Brain/Cognition
MPV17	Endocrine/Metabolic
TSC1	Skin
PNKP	Brain/Cognition
SEC24D	Face
SYN1	Brain/Cognition
CCDC22	Brain/Cognition
SKI	Skeleton
DGAT1	GI tract
DCHS1	Brain/Cognition
POLR1D	Face
ACVR1	Musculature
PHOX2B	Endocrine/Metabolic
ST14	Skin
PLA2G6	Brain/Cognition
BRWD3	Brain/Cognition
WDR62	Brain/Cognition
MYT1L	Brain/Cognition
PPP2R5D	Brain/Cognition
B9D1	Skeleton
ERCC8	Skin
COL4A2	Brain/Cognition
DKC1	Bone Marrow/Immune
NPC1	Endocrine/Metabolic
GJA3	Eye
DPM1	Endocrine/Metabolic
DLG3	Brain/Cognition
STAR	Genitalia
GALE	Endocrine/Metabolic
MMACHC	Skeleton
FYCO1	Eye
BBS2	Skeleton
APOPT1	Endocrine/Metabolic
FBXL4	Endocrine/Metabolic
FBP1	Endocrine/Metabolic
AGXT	Kidney Renal Tract
C21orf59	Respiratory tract
TUSC3	Brain/Cognition
TSEN2	Brain/Cognition
LRIG2	Kidney Renal Tract
SNIP1	Skeleton
PCYT1A	Skeleton
ZSWIM6	Face
MAP2K2	Skin
CAPRIN1	Brain/Cognition
MMP14	Skeleton
TAF2	Brain/Cognition
RAB23	Skeleton
TMPRSS6	Bone Marrow/Immune
HMGCS2	Endocrine/Metabolic
ASS1	Endocrine/Metabolic
POLG	Brain/Cognition
VPS33B	Kidney Renal Tract
DCDC2	Kidney Renal Tract
RNASET2	Brain/Cognition
MGP	Skeleton
TCOF1	Face
DOCK7	Brain/Cognition
AIMP1	Brain/Cognition
HDAC4	Skeleton
CRBN	Brain/Cognition
ROGDI	Teeth & Dentitian
NRAS	Skin
NBN	Bone Marrow/Immune
LMX1B	Skin
ACAT1	Endocrine/Metabolic
TSHB	Endocrine/Metabolic
NPHP3	Kidney Renal Tract
KDM5A	Brain/Cognition
PDE6H	Eye
DIS3L2	Cancer predisposition
GTF2H5	Bone Marrow/Immune
HYAL1	Skeleton
HCFC1	Brain/Cognition
RNF168	Bone Marrow/Immune
CEP83	Kidney Renal Tract
ITPR1	Brain/Cognition
WAC	Brain/Cognition
CHD8	Brain/Cognition
CYP1B1	Eye
SF3B4	Face
HNRNPU	Brain/Cognition
ATP8A2	Brain/Cognition
BTD	Skin
SYP	Brain/Cognition
UROC1	Endocrine/Metabolic
IGFBP7	Eye
IVD	Endocrine/Metabolic
LRIT3	Eye
SIL1	Skeleton
SOX5	Brain/Cognition
PORCN	Skin
NAA15	Heart/Cardiovasculature/Lymphatic
BBS7	Skeleton
PTH	Skeleton
ETHE1	Endocrine/Metabolic
CTSK	Skeleton
COL3A1	Skin
CCDC8	Skeleton
LIPN	Skin
SLC24A1	Eye
ATM	Bone Marrow/Immune
ERCC4	Skin
TMEM70	Endocrine/Metabolic
PGM1	Face
NEK1	Skeleton
FOXP1	Brain/Cognition
SMARCAL1	Skeleton
SPECC1L	Face
DHCR7	Face
LARP7	Teeth & Dentitian
KMT2A	Skin
CYB5R3	Bone Marrow/Immune
CRADD	Brain/Cognition
PHF8	Brain/Cognition
ARSE	Skeleton
GRM1	Brain/Cognition
STIL	Brain/Cognition
PIGN	Brain/Cognition
MAF	Eye
BIN1	Musculature
DARS	Brain/Cognition
CDKN1C	Endocrine/Metabolic
CHD2	Brain/Cognition
CHM	Eye
PTCH1	Skin
ERCC1	Bone Marrow/Immune
POC1A	Skeleton
BMPR1B	Skeleton
MUT	Endocrine/Metabolic
PSAT1	Brain/Cognition
TSHZ1	Ear
PACS1	Brain/Cognition
FANCI	Bone Marrow/Immune
GSPT2	Brain/Cognition
GLIS3	Kidney Renal Tract
RNF113A	Skin
PPP2R1A	Brain/Cognition
KIF4A	Brain/Cognition
MAOA	Brain/Cognition
MEGF8	Skeleton
SKIV2L	Skin
BBS12	Skeleton
C4orf26	Teeth & Dentitian
AFF4	Brain/Cognition
IFITM5	Skeleton
NPC2	Endocrine/Metabolic
SLC9A9	Brain/Cognition
CIC	Brain/Cognition
EIF4A3	Face
CACNA1H	Brain/Cognition
ST3GAL3	Brain/Cognition
CLCN4	Brain/Cognition
MAB21L2	Skeleton
ATP6AP2	Brain/Cognition
SLC33A1	Endocrine/Metabolic
FGD1	Face
PRMT9	Brain/Cognition
HPGD	Skeleton
COQ8A	Musculature
XPA	Bone Marrow/Immune
TDRD7	Eye
TTI2	Brain/Cognition
NODAL	GI tract
BLM	Bone Marrow/Immune
TMEM135	Brain/Cognition
MEOX1	Skeleton
IL11	Teeth & Dentitian
AMT	Endocrine/Metabolic
XPNPEP3	Kidney Renal Tract
CUL7	Skeleton
CTSD	Endocrine/Metabolic
RAB3GAP1	Brain/Cognition
EDNRB	Multisystem
SDCCAG8	Kidney Renal Tract
ATP6V1B2	Teeth & Dentitian
PQBP1	Brain/Cognition
MCPH1	Brain/Cognition
NEXMIF	Brain/Cognition
SPAG1	Respiratory tract
GLE1	Skeleton
CCDC39	Multisystem
NUBPL	Endocrine/Metabolic
ITGA6	Skin
GPC6	Skeleton
POMP	Skin
EZH2	Skeleton
GLMN	Heart/Cardiovasculature/Lymphatic
COL4A4	Kidney Renal Tract
TK2	Endocrine/Metabolic
ETFB	Endocrine/Metabolic
UTP4	GI tract
TXNL4A	Face
ITGA8	Kidney Renal Tract
ORC6	Skeleton
POU1F1	Endocrine/Metabolic
ENTPD1	Brain/Cognition
EFNB1	Face
CC2D1A	Brain/Cognition
UBR7	Brain/Cognition
DDX59	Face
NDUFB11	Endocrine/Metabolic
GM2A	Endocrine/Metabolic
MCOLN1	Endocrine/Metabolic
ERF	Face
EDNRA	Face
TRIM37	Musculature
AKR1D1	Endocrine/Metabolic
RANBP2	Brain/Cognition
SCRIB	Brain/Cognition
PGAP3	Endocrine/Metabolic
SPTLC2	Peripheral nerves
HIST1H4B	Brain/Cognition
ACADVL	Endocrine/Metabolic
PCCB	Endocrine/Metabolic
FOXP3	Bone Marrow/Immune
NOTCH3	Skin
BSND	Kidney Renal Tract
COX6B1	Musculature
PUF60	Kidney Renal Tract
PALB2	Bone Marrow/Immune
VIP	Brain/Cognition
PGM3	Bone Marrow/Immune
SUCLG1	Endocrine/Metabolic
INPP4A	Brain/Cognition
SLC31A1	Brain/Cognition
CSTB	Brain/Cognition
TH	Brain/Cognition
MAGT1	Brain/Cognition
CCDC65	Respiratory tract
DRC1	Respiratory tract
RAD50	Bone Marrow/Immune
RNASEH2C	Skin
PYCR2	Brain/Cognition
SBDS	Bone Marrow/Immune
RTTN	Brain/Cognition
IGF1	Skeleton
FRAS1	Skin
SNX14	Brain/Cognition
PDGFRB	Musculature
SPRTN	Bone Marrow/Immune
FBXO25	Brain/Cognition
GATM	Endocrine/Metabolic
AHDC1	Brain/Cognition
DDOST	Endocrine/Metabolic
RAB18	Brain/Cognition
CHRNA1	Musculature
CDKL5	Brain/Cognition
KCNB1	Brain/Cognition
PSAP	Endocrine/Metabolic
GMPPA	Endocrine/Metabolic
EEF1A2	Brain/Cognition
TPP1	Endocrine/Metabolic
PIEZO2	Musculature
ZBTB20	Brain/Cognition
EOMES	Brain/Cognition
VIPAS39	Kidney Renal Tract
CISD2	Endocrine/Metabolic
DDX11	Bone Marrow/Immune
TSEN54	Brain/Cognition
FOXRED1	Endocrine/Metabolic
POLR1A	Face
GALNS	Skeleton
COG8	Endocrine/Metabolic
PLOD1	Skin
UQCRB	Endocrine/Metabolic
SHANK1	Brain/Cognition
HYDIN	GI tract
TCTN3	Skeleton
KIF22	Skeleton
NDUFA1	Endocrine/Metabolic
GLIS2	Kidney Renal Tract
ASXL1	Face
TBR1	Brain/Cognition
CLN5	Endocrine/Metabolic
CREBBP	Skeleton
GPC3	Face
SHOC2	Skin
EIF2AK3	Skeleton
ACTG1	Brain/Cognition
HLCS	Endocrine/Metabolic
ZMYND11	Face
USB1	Bone Marrow/Immune
STAT2	Multisystem
RIN2	Skin
HACE1	Brain/Cognition
KIAA0586	Brain/Cognition
MMP21	GI tract
PRMT7	Skeleton
SCN3A	Brain/Cognition
TUBB	Skin
MAPRE2	Bone Marrow/Immune
MECOM	Bone Marrow/Immune
HOXA11	Bone Marrow/Immune
SCYL1	Peripheral nerves
COL13A1	Musculature
SLC39A8	Brain/Cognition
GMNN	Skeleton
TAF1	Face
DKC1	Bone Marrow/Immune
TERT	Bone Marrow/Immune
PARN	Bone Marrow/Immune
TINF2	Bone Marrow/Immune
TPM2	Musculature
TCN2	Endocrine/Metabolic
CLIC2	Brain/Cognition
TERC	Bone Marrow/Immune
TRAIP	Skeleton
RTN4IP1	Endocrine/Metabolic
PPM1D	Brain/Cognition
QRICH1	Face
SET	Brain/Cognition
UNC80	Brain/Cognition
CCDC115	Endocrine/Metabolic
TANGO2	Musculature
TRIP4	Spinal cord/Peripheral nerves
ASCC1	Spinal cord/Peripheral nerves
DVL3	Skeleton
EMC1	Skeleton
FGFR1	Skin
PIGG	Brain/Cognition
GTF2E2	Bone Marrow/Immune
SMG9	Face
PDE10A	Brain/Cognition
TBCK	Musculature
GNAQ	Heart/Cardiovasculature/Lymphatic
GNA11	Heart/Cardiovasculature/Lymphatic
TELO2	Skeleton
RERE	Kidney Renal Tract
ITPR1	Eye
TRMT10C	Endocrine/Metabolic
GNB1	Brain/Cognition
GNB3	Eye
PRDM6	Heart/Cardiovasculature/Lymphatic
FLAD1	Endocrine/Metabolic
SAMD9L	Bone Marrow/Immune
MAFB	Eye
TKT	Skeleton
BGN	Skeleton
FRRS1L	Brain/Cognition
SMO	Skeleton
TFRC	Bone Marrow/Immune
CDC45	Skeleton
SEC61A1	Bone Marrow/Immune
VAC14	Brain/Cognition
TMEM126B	Musculature
TSEN15	Brain/Cognition
KLHL7	Eye
POT1	Eye
CCDC88A	Brain/Cognition
PPP1CB	Multisystem
NONO	Brain/Cognition
ATAD3A	Spinal cord/Peripheral nerves
GORAB	Skin
CYP24A1	Kidney Renal Tract
UBA5	Brain/Cognition
TBX15	Skeleton
CHD4	Brain/Cognition
SH3BP2	Skeleton
CDK13	Brain/Cognition
PRKD1	Brain/Cognition
CREBBP	Brain/Cognition
KPNA7	Brain/Cognition
PPA2	Heart/Cardiovasculature/Lymphatic
SMCHD1	Face
MYT1	Skeleton
PKD1L1	Heart/Cardiovasculature/Lymphatic
MAP3K7	Skeleton
MAP3K7	Skeleton
IL11RA	Teeth & Dentitian
IL11RA	Skeleton
EIF2S3	Brain/Cognition
PPP1R15B	Brain/Cognition
NCAPD2	Skeleton
NCAPD3	Skeleton
NCAPH	Brain/Cognition
ARCN1	Skeleton
HTRA2	Endocrine/Metabolic
PIEZO1	Heart/Cardiovasculature/Lymphatic
SNORD118	Brain/Cognition
OTULIN	Bone Marrow/Immune
USP18	Lungs
BGN	Skeleton
NLRP5	Multisystem
NANS	Skeleton
TRIT1	Musculature
PIEZO2	Musculature
BRPF1	Face
HIVEP2	Brain/Cognition
CRIM1	Eye
KMT2B	Brain/Cognition
SETD1A	Brain/Cognition
STAG1	Face
ELMO2	Skeleton
IARS	Bone Marrow/Immune
GNA14	Heart/Cardiovasculature/Lymphatic
TTC25	Lungs
DNAJB13	Lungs
CIT	Brain/Cognition
SIN3A	Face
SON	Skeleton
HNRNPH2	Brain/Cognition
SLC5A7	Musculature
EMG1	Bone Marrow/Immune
GRIN2D	Brain/Cognition
ATAD3A	Brain/Cognition
SLC25A4	Musculature
NAXE	Skin
FGF12	Brain/Cognition
EBF3	Face
KIDINS220	Endocrine/Metabolic
MBOAT7	Brain/Cognition
GLDN	Spinal cord/Peripheral nerves
TBCD	Brain/Cognition
TBCE	Spinal cord/Peripheral nerves
ASXL2	Face
CARS2	Brain/Cognition
CLTC	Brain/Cognition
CUL3	Brain/Cognition
DLG4	Brain/Cognition
FBXO11	Brain/Cognition
HECW2	Brain/Cognition
PYROXD1	Musculature
SLC6A9	Endocrine/Metabolic
TMTC3	Brain/Cognition
PLPBP	Brain/Cognition
CPAMD8	Eye
DENND5A	Brain/Cognition
AP3B2	Brain/Cognition
MDH2	Endocrine/Metabolic
DNAJC12	Endocrine/Metabolic
NEXMIF	Skeleton
MYH10	Skeleton
LRP6	GI tract
PRUNE1	Brain/Cognition
HIST1H4C	Face
EPB41L1	Brain/Cognition
HIST1H1E	Skeleton
RAB11B	Brain/Cognition
PSMD12	Kidney Renal Tract
CDH1	Teeth & Dentitian
CTNND1	Teeth & Dentitian
ACTB	Kidney Renal Tract
AFF3	Skeleton
KIAA1109	Skeleton
THOC6	Kidney Renal Tract
DNAH5	Lungs
FRMPD4	Brain/Cognition
LAS1L	Brain/Cognition
RLIM	Brain/Cognition
USP27X	Brain/Cognition
CDK16	Brain/Cognition
C21orf2	Skeleton
RRM2B	Multisystem
ZNF462	Face
WDR26	Face
ERF	Skeleton
MRPS34	Endocrine/Metabolic
UBTF	Brain/Cognition
LIPT2	Endocrine/Metabolic
TRAPPC12	Brain/Cognition
YWHAG	Brain/Cognition
LIAS	Endocrine/Metabolic
LIPT1	Endocrine/Metabolic
ARMC9	Eye: Retina
KCNQ5	Brain/Cognition
MYLK	Kidney Renal Tract
NKX6-2	Brain/Cognition
PLAA	Brain/Cognition
SLC45A1	Brain/Cognition
GZF1	Skeleton
CWC27	Skeleton
LGI4	Skeleton
TMEM260	Kidney Renal Tract
OTUD6B	Skeleton
RPS23	Face
INPP5K	Musculature
TAF13	Brain/Cognition
NACC1	Eye
TRIP13	Kidney Renal Tract
DCC	Brain/Cognition
ABL1	Skeleton
TOE1	Brain/Cognition
KDM1A	Face
COLEC10	Kidney Renal Tract
DHRS3	Skeleton
PEX11B	Skeleton
TUBG1	Brain/Cognition
HMX1	Ear
CEP290	Brain/Cognition
FLNA	Skeleton
SLX4	Skeleton
ARG1	Brain/Cognition
POLR3A	Brain/Cognition
ATR	Skeleton
FANCB	Skeleton
ALG9	Brain/Cognition
YAP1	Face
BBS9	Brain/Cognition
TRIM32	Kidney Renal Tract
PAX2	Eye
FGFR3	Skeleton
NSD1	Skeleton
NAA10	Brain/Cognition
MOGS	Brain/Cognition
AGPS	Brain/Cognition
OFD1	Face
HRAS	Face
BRIP1	Skeleton
TBX3	Skeleton
PCCA	Brain/Cognition
FKRP	Brain/Cognition
COX15	Endocrine/Metabolic
COG7	Brain/Cognition
MECP2	GI tract
BRAF	Brain/Cognition
FTL	Eye
CBL	Skeleton
POMGNT1	Brain/Cognition
COL2A1	Skeleton
TGFB3	Skeleton
PIGO	Brain/Cognition
GJA1	Skeleton
PLK4	Eye
ARSA	Brain/Cognition
CLN3	Brain/Cognition
LRP5	Eye
DOCK6	Skeleton
XPC	Skin
CLN8	Brain/Cognition
RTEL1	Brain/Cognition
GDF3	Eye
MKKS	Skeleton
NAGA	Brain/Cognition
ARX	Genitalia
SMARCA2	Skeleton
NSDHL	Skeleton
DPAGT1	Brain/Cognition
SOX9	Skeleton
AMER1	Skeleton
PLCB4	Ear
NEK8	GI tract
LDB3	Heart/Cardiovasculature/Lymphatic
CDC6	Brain/Cognition
IFT140	Skeleton
PIGV	Brain/Cognition
GRHL2	Skeleton
HADH	Brain/Cognition
OTC	Brain/Cognition
SALL1	Skeleton
JAM3	Eye
NALCN	Brain/Cognition
FOXN1	Hair/Nails
ATP7A	Skeleton
BBS10	Brain/Cognition
MTO1	Heart/Cardiovasculature/Lymphatic
FTO	Brain/Cognition
GBA	Skeleton
CHRNG	Spinal cord/Peripheral nerves
POMT2	Brain/Cognition
KIF1BP	GI tract
IFT172	Skeleton
CC2D2A	Skeleton
INPP5E	Eye
CACNA1D	Brain/Cognition
SATB2	Brain/Cognition
DOCK8	Brain/Cognition
SLC46A1	Endocrine/Metabolic
DMPK	Endocrine/Metabolic
AGA	Endocrine/Metabolic
COL11A2	Skeleton
MRPS22	Endocrine/Metabolic
HOXA1	Heart/Cardiovasculature/Lymphatic
KCNE1	Heart/Cardiovasculature/Lymphatic
GPSM2	Ear
ACTB	Eye
EBP	Brain/Cognition
PSMB8	Skeleton
PITX2	Eye
XRCC4	Brain/Cognition
PEX13	Skeleton
MAT1A	Brain/Cognition
COL9A1	Skeleton
TCF4	Brain/Cognition
GFM1	Brain/Cognition
TUBA8	Eye
FGFR2	Skeleton
BBS4	Brain/Cognition
PCNT	Brain/Cognition
BUB1B	Brain/Cognition
EYA1	Eye
SNAP29	Spinal cord/Peripheral nerves
TBX1	Brain/Cognition
RPS6KA3	Brain/Cognition
SLC25A15	Brain/Cognition
ALDH18A1	Skeleton
GLDC	Brain/Cognition
NOP10	Skin
MPDU1	Brain/Cognition
TCTN2	Skeleton
PLEC	Skin
SLC4A1	Endocrine/Metabolic
FANCC	Skeleton
SMARCE1	Brain/Cognition
DDB2	Skeleton
PIK3R1	Endocrine/Metabolic
VPS13B	Skeleton
ERCC3	Skeleton
SMPD1	Brain/Cognition
WNT4	Genitalia
B3GALT6	Skeleton
HADHA	Brain/Cognition
SLC52A3	Ear
HUWE1	Brain/Cognition
MPLKIP	Brain/Cognition
WT1	Genitalia
RECQL4	Skin
DVL1	Skeleton
ALG8	Brain/Cognition
MASP1	Skeleton
ROR2	Brain/Cognition
NDP	Eye
BCOR	Eye
ADAMTS18	Skeleton
HDAC8	Brain/Cognition
PDSS1	Brain/Cognition
FREM2	Kidney Renal Tract
HSPG2	Skeleton
ALG1	Brain/Cognition
POLD1	Ear
LRAT	Eye
KARS	Ear
GNPTAB	Endocrine/Metabolic
SLC35C1	Face
SATB2	Skeleton
SNX3	Brain/Cognition
NDUFS8	Brain/Cognition
KRIT1	Brain/Cognition
ALG11	Brain/Cognition
PEX5	Skeleton
HESX1	Brain/Cognition
WDR60	Brain/Cognition
IKBKG	Skin
RASA1	Heart/Cardiovasculature/Lymphatic
FANCF	Skeleton
FH	Endocrine/Metabolic
MYO7A	Ear
RUNX2	Skeleton
OCRL	Endocrine/Metabolic
RFX6	GI tract
LRPPRC	Brain/Cognition
PET100	Brain/Cognition
SRCAP	Brain/Cognition
PRRX1	Ear
EVC	Skeleton
ZFYVE26	Eye
ELN	Heart/Cardiovasculature/Lymphatic
RNASEH2A	Brain/Cognition
GJB3	Ear
SMARCB1	Skeleton
MOCS1	Brain/Cognition
PAX6	Eye
SH3PXD2B	Eye
NR2F1	Eye
KAT6B	Brain/Cognition
GLI3	Skeleton
PIP5K1C	Spinal cord/Peripheral nerves
PAH	Endocrine/Metabolic
TGFBR1	Skeleton
FKTN	Brain/Cognition
LMNA	Heart/Cardiovasculature/Lymphatic
COQ4	Brain/Cognition
CDH23	Ear
STS	Eye
ASAH1	Spinal cord/Peripheral nerves
MMAA	Brain/Cognition
PEX14	Brain/Cognition
PGAP2	Brain/Cognition
STRA6	Eye
MYH3	Skeleton
HCCS	Eye
STAMBP	Brain/Cognition
TGFBR2	Skeleton
PEX16	Endocrine/Metabolic
DPM3	Endocrine/Metabolic
DDC	Brain/Cognition
NFU1	Brain/Cognition
PIK3CA	Endocrine/Metabolic
DHODH	Skeleton
PRPS1	Endocrine/Metabolic
GLB1	Brain/Cognition
DMP1	Endocrine/Metabolic
RAX	Eye
SLC25A19	Brain/Cognition
B3GALNT2	Brain/Cognition
ARHGAP31	Skeleton
BBS5	Brain/Cognition
DHTKD1	Brain/Cognition
ANO5	Skeleton
GAMT	Brain/Cognition
PLOD3	Face
ARID1B	Skeleton
PLXND1	Eye
PLCG2	Skin
SHROOM3	Spinal cord/Peripheral nerves
WWOX	Brain/Cognition
TRPS1	Face
BMP4	Skeleton
MGAT2	Endocrine/Metabolic
GALT	Brain/Cognition
UGT1A1	GI tract
LYST	Skin
ZEB2	Brain/Cognition
TTC8	Skeleton
PRKAR1A	Endocrine/Metabolic
IFT43	Skeleton
FLVCR2	Heart/Cardiovasculature/Lymphatic
ANTXR1	Skin
EHMT1	Brain/Cognition
CDT1	Brain/Cognition
TTN	Heart/Cardiovasculature/Lymphatic
SLC13A5	Brain/Cognition
ERCC6	Brain/Cognition
MANBA	Endocrine/Metabolic
PTDSS1	Skeleton
SLC25A20	Brain/Cognition
PEX1	Skeleton
TREX1	Brain/Cognition
RAD21	Skeleton
HPD	Brain/Cognition
GNPAT	Skeleton
COG5	Brain/Cognition
HEXB	Brain/Cognition
MED13L	Heart/Cardiovasculature/Lymphatic
PCBD1	Brain/Cognition
TEK	Heart/Cardiovasculature/Lymphatic
BCAP31	Ear
HSD17B4	Ear
ANKRD11	Skeleton
VANGL1	Spinal cord/Peripheral nerves
NF1	Spinal cord/Peripheral nerves
PTF1A	Brain/Cognition
FOXL2	Heart/Cardiovasculature/Lymphatic
SMARCA4	Brain/Cognition
FANCG	Skeleton
ASPH	Eye
SUMF1	Brain/Cognition
PEX6	Endocrine/Metabolic
CIB2	Ear
PDCD10	Heart/Cardiovasculature/Lymphatic
C2CD3	Brain/Cognition
PTEN	Skeleton
FGFR1	Skeleton
SGSH	Brain/Cognition
ORC1	Brain/Cognition
FANCE	Skeleton
ARL6	Endocrine/Metabolic
IDUA	Endocrine/Metabolic
DNMT3A	Brain/Cognition
UVSSA	Skin
PTPN14	Skeleton
ROBO3	Eye
BBS1	Brain/Cognition
MT-TP	Endocrine/Metabolic
ALG12	Endocrine/Metabolic
NFIX	Brain/Cognition
MFSD8	Eye
ERCC2	Skeleton
PDSS2	Brain/Cognition
GUSB	Skeleton
HSD17B10	Brain/Cognition
RET	Endocrine/Metabolic
RIT1	Skeleton
ZMPSTE24	Face
ERCC4	Skin
TAC3	Genitalia
PEX26	Skeleton
DARS2	Brain/Cognition
MLYCD	Brain/Cognition
KIT	Cancer predisposition
RBM28	Endocrine/Metabolic
HGSNAT	Brain/Cognition
GCDH	Brain/Cognition
PIGL	Brain/Cognition
ZFPM2	Heart/Cardiovasculature/Lymphatic
ABCC9	Heart/Cardiovasculature/Lymphatic
CLPP	Genitalia
KDM6A	Face
GDF6	Eye
TMEM67	Skeleton
ZIC3	Heart/Cardiovasculature/Lymphatic
ACVR2B	Heart/Cardiovasculature/Lymphatic
MITF	Ear
MMADHC	Endocrine/Metabolic
GALK1	Eye
CRB2	Brain/Cognition
PC	Brain/Cognition
PEX12	Endocrine/Metabolic
TMEM5	Genitalia
CRYAB	Eye
FOXF1	Genitalia
SOX2	Brain/Cognition
SURF1	Brain/Cognition
KIF11	Eye
RPGRIP1L	Brain/Cognition
ABCD4	Brain/Cognition
OPHN1	Brain/Cognition
GJB2	Ear
ACADM	Brain/Cognition
SMAD3	Heart/Cardiovasculature/Lymphatic
TACR3	Genitalia
CASK	Brain/Cognition
ETFDH	Brain/Cognition
TFAP2B	Skeleton
AR	Brain/Cognition
SALL4	Skeleton
GRHL3	GI tract
IRF6	Skeleton
HYLS1	Skeleton
BANF1	Skeleton
DYM	Brain/Cognition
NDUFV1	Brain/Cognition
DOLK	Brain/Cognition
ATRX	Brain/Cognition
IFT122	Face
WDR19	Skeleton
CEP152	Skeleton
DSPP	Ear
TBC1D24	Brain/Cognition
C12orf65	Brain/Cognition
FAM111A	Endocrine/Metabolic
MPI	Brain/Cognition
MCCC2	Brain/Cognition
PDHA1	Brain/Cognition
GJC2	Heart/Cardiovasculature/Lymphatic
PMM2	Brain/Cognition
SOX10	Face
UMPS	Endocrine/Metabolic
PEX19	Endocrine/Metabolic
SLC4A4	Endocrine/Metabolic
DSG1	Skin
FLVCR1	Eye
THRA	Brain/Cognition
CLCNKB	Endocrine/Metabolic
TUBGCP6	Eye
RRAS	Brain/Cognition
NECTIN4	Skeleton
GLUL	Brain/Cognition
ORC4	Brain/Cognition
COLEC11	Skeleton
CHD7	Brain/Cognition
NFIA	Brain/Cognition
NEU1	Endocrine/Metabolic
CDH3	Eye
PAX3	GI tract
NKX2-1	Brain/Cognition
SNRPB	Skeleton
CTSA	Endocrine/Metabolic
SLC19A3	Brain/Cognition
GNAS	Endocrine/Metabolic
GNS	Endocrine/Metabolic
SLC6A8	Skeleton
PHGDH	Brain/Cognition
ALDH5A1	Brain/Cognition
PEX7	Skeleton
NDUFS4	Brain/Cognition
COL4A1	Heart/Cardiovasculature/Lymphatic
POMT1	Brain/Cognition
SLC39A13	Skeleton
CEP63	Endocrine/Metabolic
DHFR	Endocrine/Metabolic
HARS	Ear
CA2	Skeleton
GCSH	Brain/Cognition
CHUK	Face
RNASEH2B	Brain/Cognition
ACOX1	Brain/Cognition
CACNA1A	Heart/Cardiovasculature/Lymphatic
MIR17HG	Brain/Cognition
DHCR24	Skeleton
ZBTB16	Brain/Cognition
MAP2K1	Skeleton
TBCE	Skeleton
JAG1	Heart/Cardiovasculature/Lymphatic
SOX3	Brain/Cognition
TIMM8A	Brain/Cognition
SCARF2	Skeleton
DCAF17	Endocrine/Metabolic
MTRR	Endocrine/Metabolic
TP63	Face
LAMA2	Brain/Cognition
PTS	Brain/Cognition
FBN2	Ear
AAAS	Endocrine/Metabolic
USP9X	GI tract
DNAAF3	Genitalia
DNMT3B	Brain/Cognition
SMC3	Brain/Cognition
SMOC1	Skeleton
SLC2A2	Endocrine/Metabolic
DNA2	Brain/Cognition
LRP2	Brain/Cognition
ESCO2	Skeleton
CCBE1	Brain/Cognition
DYNC2H1	Skeleton
RNU4ATAC	Heart/Cardiovasculature/Lymphatic
RAPSN	Spinal cord/Peripheral nerves
CD151	Kidney Renal Tract
ADSL	Brain/Cognition
COG1	Brain/Cognition
ELOVL4	Brain/Cognition
ZC4H2	Skeleton
CLDN19	Eye
ALS2	Brain/Cognition
SHH	Face
BOLA3	Brain/Cognition
TCF12	Skeleton
TAT	Endocrine/Metabolic
TTC19	Brain/Cognition
MNX1	Spinal cord/Peripheral nerves
AASS	Brain/Cognition
TFAP2A	Face
TBXAS1	Skeleton
FANCL	Skeleton
EDA	Skin
COL11A1	Eye
SLC22A5	Brain/Cognition
AIFM1	Brain/Cognition
KCNJ11	Brain/Cognition
PSPH	Brain/Cognition
FGF3	Ear
ISPD	Eye
FAM58A	Face
WRAP53	Skin
KRAS	Face
TBX5	Heart/Cardiovasculature/Lymphatic
MKS1	Skeleton
COL9A2	Skeleton
PEX3	Endocrine/Metabolic
EXOSC3	Brain/Cognition
FANCD2	Skeleton
AUH	Brain/Cognition
PEX2	Skeleton
EXT1	Face
DBT	Brain/Cognition
BCKDHA	Brain/Cognition
SLC35A1	Brain/Cognition
QDPR	Brain/Cognition
KMT2D	Face
HINT1	Spinal cord/Peripheral nerves
UBR1	Skeleton
ALG6	Brain/Cognition
SLC17A5	Brain/Cognition
ARID1A	Skeleton
MED12	Brain/Cognition
SCN1B	Heart/Cardiovasculature/Lymphatic
RAI1	Skeleton
CD96	Brain/Cognition
TUBB3	Eye
CCDC151	Respiratory tract
KCNJ6	Brain/Cognition
TUBGCP4	Eye
GAA	Heart/Cardiovasculature/Lymphatic
PTH1R	Endocrine/Metabolic
KCTD1	Eye
GFER	Ear
TMEM165	Brain/Cognition
FAM126A	Eye
HNF1B	Endocrine/Metabolic
MOCS2	Brain/Cognition
HR	Hair/Nails
SLC12A6	Spinal cord/Peripheral nerves
SLC35A2	Brain/Cognition
ABCD1	Brain/Cognition
SMS	Skeleton
FTCD	Endocrine/Metabolic
KCNQ2	Brain/Cognition
ASPA	Brain/Cognition
EP300	Skeleton
UPF3B	Brain/Cognition
SAMHD1	Brain/Cognition
MYH8	Skeleton
SIX5	Face
PPT1	Brain/Cognition
BRCA2	Skeleton
CENPJ	Skeleton
MICU1	Endocrine/Metabolic
NDUFS1	Brain/Cognition
EPG5	Skin
SIX1	Ear
SETBP1	Skeleton
PNPLA2	Endocrine/Metabolic
ETFA	Brain/Cognition
NECTIN1	Face
CBS	Endocrine/Metabolic
NIPBL	Face
KCNQ1	Heart/Cardiovasculature/Lymphatic
KCNK9	Brain/Cognition
ELAC2	Brain/Cognition
PTPN11	Ear
TWIST1	Brain/Cognition
EOGT	Skeleton
OBSL1	Brain/Cognition
RARB	Eye
MMAB	Brain/Cognition
MTHFR	Brain/Cognition
LARS2	Genitalia
HMGCL	Brain/Cognition
ALDOA	Endocrine/Metabolic
NAGLU	Endocrine/Metabolic
WDR73	Brain/Cognition
NOTCH2	Skeleton
PEX10	Skeleton
ARSB	Endocrine/Metabolic
RMND1	Brain/Cognition
NHS	Eye
COX7B	Eye
PEPD	Endocrine/Metabolic
NGLY1	Brain/Cognition
SC5D	Brain/Cognition
ALMS1	Brain/Cognition
FGF10	Skeleton
ABHD5	Musculature
FAR1	Brain/Cognition
NDUFS7	Brain/Cognition
CYC1	Brain/Cognition
P4HB	Skeleton
ANKH	Brain/Cognition
ACO2	Brain/Cognition
GNPTG	Endocrine/Metabolic
TTC7A	GI tract
PGK1	Musculature
CLCNKA	Endocrine/Metabolic
FANCA	Skeleton
LEFTY2	Heart/Cardiovasculature/Lymphatic
ACY1	Brain/Cognition
GTPBP3	Brain/Cognition
ACSL4	Brain/Cognition
ITGA3	Kidney Renal Tract
LARGE1	Brain/Cognition
SLC16A2	Brain/Cognition
HPRT1	Brain/Cognition
ASXL3	Brain/Cognition
DAG1	Brain/Cognition
ABCB7	Brain/Cognition
CTC1	Heart/Cardiovasculature/Lymphatic
FAH	Endocrine/Metabolic
SMC1A	Brain/Cognition
CHST14	Eye
FUCA1	Endocrine/Metabolic
CACNA1C	Heart/Cardiovasculature/Lymphatic
COL4A3	Eye
IDS	Endocrine/Metabolic
BCS1L	Endocrine/Metabolic
PHF6	Brain/Cognition
KIF1A	Brain/Cognition
FAM20C	Brain/Cognition
RAF1	Skeleton
SRD5A3	Brain/Cognition
IARS2	Brain/Cognition
MID1	Brain/Cognition
VLDLR	Brain/Cognition
MEF2C	Brain/Cognition
SOBP	Brain/Cognition
AK2	Ear
HSD3B7	GI tract
IGSF1	Genitalia
ERCC6L2	Brain/Cognition
CEP57	Brain/Cognition
HPSE2	Face
IRX5	Face
LMBRD1	Endocrine/Metabolic
LAMP2	Heart/Cardiovasculature/Lymphatic
HNF4A	Endocrine/Metabolic
OTX2	Brain/Cognition
UQCRQ	Brain/Cognition
GATA2	Heart/Cardiovasculature/Lymphatic
SDHAF1	Brain/Cognition
FBN1	Eye
ATP8B1	GI tract
FIG4	Spinal cord/Peripheral nerves
MAN2B1	Endocrine/Metabolic
RAD51C	Skeleton
NDUFAF2	Brain/Cognition
IGBP1	Brain/Cognition
GCH1	Brain/Cognition
LIG4	Brain/Cognition
COA5	Brain/Cognition
COL25A1	Eye
POLR1C	Ear
KCNH1	Brain/Cognition
IFIH1	Teeth & Dentitian
HEXA	Brain/Cognition
ATP6V1B1	Ear
SMAD4	GI tract
ALX4	Skeleton
SCO2	Brain/Cognition
MAF	Brain/Cognition
WDPCP	Skeleton
FREM1	Kidney Renal Tract
CKAP2L	Skeleton
UBE3A	Brain/Cognition
POLR3B	Endocrine/Metabolic
SEC23A	Eye
WNT5A	Skeleton
UBE3B	Skeleton
COX10	Endocrine/Metabolic
ALG3	Brain/Cognition
WDR11	Genitalia
ALDH1A3	Eye
SOS1	Brain/Cognition
COX14	Brain/Cognition
CUL4B	Genitalia
TMCO1	Skeleton
FOLR1	Brain/Cognition
PAPSS2	Endocrine/Metabolic
SDHA	Brain/Cognition
COL9A3	Skeleton
ERCC5	Skeleton
TSC2	Kidney Renal Tract
NPHP1	Eye
VDR	Endocrine/Metabolic
TUFM	Brain/Cognition
PIGT	Endocrine/Metabolic
TYRP1	Eye
CSPP1	Brain/Cognition
ALG2	Brain/Cognition
TACO1	Brain/Cognition
CCND2	Brain/Cognition
TTC37	GI tract
GNAI3	Ear
ALDH4A1	Brain/Cognition
RBPJ	Skeleton
ERBB3	Spinal cord/Peripheral nerves
CTDP1	Spinal cord/Peripheral nerves
EVC2	Skeleton
LONP1	Brain/Cognition
CRELD1	Heart/Cardiovasculature/Lymphatic
ACAD9	Brain/Cognition
EDN1	Ear
ATIC	Brain/Cognition
CPS1	Brain/Cognition
DYRK1A	Brain/Cognition
PREPL	Endocrine/Metabolic
DDX58	Skin
DECR1	Brain/Cognition
POMGNT2	Eye
AKT1	Skeleton
BCKDHB	Brain/Cognition
TAZ	Brain/Cognition
MTR	Endocrine/Metabolic
MYCN	Brain/Cognition
ACP5	Skeleton
RBM8A	Skeleton
KCNJ10	Brain/Cognition
FANCM	Skeleton
COL18A1	Skeleton
COG4	Brain/Cognition
TYR	Eye
IGHMBP2	Respiratory tract
TRAPPC11	Brain/Cognition
SPEG	Heart/Cardiovasculature/Lymphatic
HIBCH	Brain/Cognition
SCO1	Endocrine/Metabolic
LHX3	Endocrine/Metabolic
NHP2	Endocrine/Metabolic
NEB	Spinal cord/Peripheral nerves
L2HGDH	Brain/Cognition
FGF9	Ear
RAB3GAP2	Eye
TGDS	Skeleton
LBR	Skeleton
MTOR	Brain/Cognition
HOXA13	Genitalia
SLC27A4	Respiratory tract
HPS1	Skin
CCDC103	GI tract
STT3B	Brain/Cognition
CLPB	Endocrine/Metabolic
DMD	Brain/Cognition
RBM10	Brain/Cognition
EFTUD2	Brain/Cognition
APTX	Brain/Cognition
MCCC1	Brain/Cognition
LTBP3	Skeleton
FKBP14	Skin
FOXC2	Heart/Cardiovasculature/Lymphatic
DLD	Brain/Cognition
PAX8	Brain/Cognition
KDM5C	Brain/Cognition
MPV17	GI tract
TSC1	Kidney Renal Tract
SEC24D	Skeleton
SKI	Brain/Cognition
POLR1D	Ear
ACVR1	Skeleton
PHOX2B	Brain/Cognition
B9D1	Brain/Cognition
ERCC8	Skeleton
COL4A2	Heart/Cardiovasculature/Lymphatic
DKC1	Skin
NPC1	Brain/Cognition
DPM1	Brain/Cognition
GALE	Brain/Cognition
MMACHC	Endocrine/Metabolic
BBS2	Brain/Cognition
APOPT1	Brain/Cognition
FBXL4	Brain/Cognition
AGXT	Endocrine/Metabolic
LRIG2	Face
SNIP1	Brain/Cognition
PCYT1A	Eye
ZSWIM6	Skeleton
MAP2K2	Skeleton
RAB23	Brain/Cognition
VPS33B	Skeleton
DCDC2	GI tract
MGP	Brain/Cognition
TCOF1	Ear
HDAC4	Brain/Cognition
ROGDI	Brain/Cognition
NRAS	Brain/Cognition
NBN	Skeleton
LMX1B	Skeleton
TSHB	Brain/Cognition
NPHP3	GI tract
GTF2H5	Skin
HYAL1	Endocrine/Metabolic
RNF168	Face
CEP83	Brain/Cognition
BTD	Endocrine/Metabolic
UROC1	Brain/Cognition
IGFBP7	Heart/Cardiovasculature/Lymphatic
IVD	Brain/Cognition
SIL1	Endocrine/Metabolic
PORCN	Skeleton
BBS7	Brain/Cognition
ETHE1	Brain/Cognition
COL3A1	Skeleton
CCDC8	Brain/Cognition
ATM	Brain/Cognition
ERCC4	Skeleton
TMEM70	Brain/Cognition
PGM1	Endocrine/Metabolic
DHCR7	Skeleton
LARP7	Skin
KMT2A	Skeleton
CYB5R3	Endocrine/Metabolic
ARSE	Brain/Cognition
CDKN1C	Cancer predisposition
PTCH1	Brain/Cognition
ERCC1	Endocrine/Metabolic
MUT	Brain/Cognition
FANCI	Skeleton
GLIS3	Endocrine/Metabolic
RNF113A	Skeleton
MEGF8	GI tract
SKIV2L	GI tract
BBS12	Brain/Cognition
NPC2	Brain/Cognition
EIF4A3	Skeleton
MAB21L2	Brain/Cognition
SLC33A1	Eye
FGD1	Skeleton
COQ8A	Endocrine/Metabolic
XPA	Skin
NODAL	Heart/Cardiovasculature/Lymphatic
BLM	Skin
IL11	Skeleton
AMT	Brain/Cognition
CUL7	Brain/Cognition
CTSD	Brain/Cognition
RAB3GAP1	Eye
SDCCAG8	Eye
ATP6V1B2	Skin
PQBP1	Eye
GLE1	Spinal cord/Peripheral nerves
NUBPL	Brain/Cognition
ITGA6	GI tract
EZH2	Brain/Cognition
COL4A4	Eye
TK2	Brain/Cognition
ETFB	Brain/Cognition
TXNL4A	Heart/Cardiovasculature/Lymphatic
ORC6	Brain/Cognition
EFNB1	Skeleton
DDX59	Skeleton
NDUFB11	Eye
GM2A	Brain/Cognition
MCOLN1	Brain/Cognition
ERF	Skeleton
EDNRA	Hair/Nails
TRIM37	Brain/Cognition
AKR1D1	GI tract
SCRIB	Eye
PGAP3	Brain/Cognition
PCCB	Brain/Cognition
FOXP3	Endocrine/Metabolic
NOTCH3	GI tract
BSND	Ear
COX6B1	Endocrine/Metabolic
PUF60	Skeleton
PALB2	Skeleton
PGM3	Skeleton
SUCLG1	Brain/Cognition
RAD50	Brain/Cognition
RNASEH2C	Brain/Cognition
SBDS	Endocrine/Metabolic
IGF1	Brain/Cognition
FRAS1	Eye
PDGFRB	Skin
SPRTN	Cancer predisposition
GATM	Brain/Cognition
DDOST	Brain/Cognition
RAB18	Eye
CHRNA1	Spinal cord/Peripheral nerves
PSAP	Brain/Cognition
GMPPA	Brain/Cognition
TPP1	Brain/Cognition
PIEZO2	Eye
VIPAS39	Skeleton
CISD2	Brain/Cognition
DDX11	Skin
FOXRED1	Brain/Cognition
POLR1A	Skeleton
GALNS	Endocrine/Metabolic
COG8	Brain/Cognition
PLOD1	Skeleton
UQCRB	Brain/Cognition
HYDIN	Respiratory tract
NDUFA1	Brain/Cognition
ASXL1	Brain/Cognition
CLN5	Brain/Cognition
CREBBP	Brain/Cognition
GPC3	Skeleton
SHOC2	Skeleton
EIF2AK3	Endocrine/Metabolic
ACTG1	Eye
ZMYND11	Brain/Cognition
USB1	Skin
STAT2	Brain/Cognition
RIN2	Skeleton
MMP21	Brain/Cognition
PRMT7	Brain/Cognition
TUBB	Skeleton
MAPRE2	Skin
MECOM	Skeleton
HOXA11	Skeleton
SCYL1	GI tract
COL13A1	Peripheral nerves
GMNN	Brain/Cognition
TAF1	Brain/Cognition
DKC1	Skeleton
TERT	Skin
PARN	Skin
TINF2	Skin
TCN2	Brain/Cognition
CLIC2	Heart/Cardiovasculature/Lymphatic
TRAIP	Brain/Cognition
RTN4IP1	Brain/Cognition
QRICH1	Brain/Cognition
CCDC115	GI tract
TANGO2	Endocrine/Metabolic
TRIP4	Skeleton
ASCC1	Skeleton
DVL3	Face
EMC1	Brain/Cognition
FGFR1	Skeleton
GTF2E2	Skin
SMG9	Brain/Cognition
TBCK	Face
TELO2	Face
RERE	Face
ITPR1	Brain/Cognition
TRMT10C	Brain/Cognition
FLAD1	Brain/Cognition
SAMD9L	Brain/Cognition
MAFB	Ear
TKT	Brain/Cognition
SMO	Face
CDC45	Brain/Cognition
SEC61A1	Kidney Renal Tract
TMEM126B	Endocrine/Metabolic
KLHL7	Brain/Cognition
POT1	Brain/Cognition
PPP1CB	Hair/Nails
NONO	Heart/Cardiovasculature/Lymphatic
ATAD3A	Endocrine/Metabolic
GORAB	Skeleton
CYP24A1	Endocrine/Metabolic
TBX15	Face
CHD4	Heart/Cardiovasculature/Lymphatic
SH3BP2	Face
CDK13	Heart/Cardiovasculature/Lymphatic
PRKD1	Heart/Cardiovasculature/Lymphatic
SMCHD1	Eye
MYT1	Face
MAP3K7	Face
IL11RA	Skeleton
IL11RA	Face
NCAPD2	Brain/Cognition
NCAPD3	Brain/Cognition
ARCN1	Brain/Cognition
HTRA2	Brain/Cognition
OTULIN	Skin
USP18	Skeleton
BGN	Face
NLRP5	Brain/Cognition
NANS	Brain/Cognition
TRIT1	Endocrine/Metabolic
PIEZO2	Skeleton
BRPF1	Brain/Cognition
STAG1	Brain/Cognition
ELMO2	Heart/Cardiovasculature/Lymphatic
IARS	Musculature
TTC25	GI tract
DNAJB13	Genitalia
SIN3A	Brain/Cognition
SON	Brain/Cognition
SLC5A7	Peripheral nerves
EMG1	Multisystem
SLC25A4	Brain/Cognition
NAXE	Brain/Cognition
EBF3	Brain/Cognition
KIDINS220	Eye
TBCE	Brain/Cognition
ASXL2	Brain/Cognition
SLC6A9	Brain/Cognition
MDH2	Brain/Cognition
DNAJC12	Brain/Cognition
NEXMIF	Brain/Cognition
MYH10	Respiratory tract
HIST1H4C	Brain/Cognition
HIST1H1E	Brain/Cognition
PSMD12	Face
CDH1	Face
CTNND1	Face
ACTB	Brain/Cognition
AFF3	Brain/Cognition
KIAA1109	Brain/Cognition
THOC6	Face
DNAH5	Liver
RLIM	Genitalia
C21orf2	Eye
RRM2B	Brain/Cognition
ZNF462	Multisystem
WDR26	Brain/Cognition
ERF	Face
MRPS34	Brain/Cognition
LIPT2	Brain/Cognition
LIAS	Brain/Cognition
LIPT1	Brain/Cognition
ARMC9	Brain/Cognition
MYLK	GI tract
GZF1	Eye
CWC27	Eye
LGI4	Peripheral nerves
TMEM260	Brain/Cognition
OTUD6B	Brain/Cognition
RPS23	Brain/Cognition
INPP5K	Skeleton
NACC1	Brain/Cognition
TRIP13	Skeleton
ABL1	Heart/Cardiovasculature/Lymphatic
KDM1A	Brain/Cognition
COLEC10	Face
DHRS3	Face
PEX11B	Multisystem
FLNA	Brain/Cognition
SLX4	Brain/Cognition
POLR3A	Genitalia
ATR	Brain/Cognition
FANCB	Cancer predisposition
YAP1	Brain/Cognition
BBS9	Eye
TRIM32	Brain/Cognition
FGFR3	Heart/Cardiovasculature/Lymphatic
NSD1	Brain/Cognition
NAA10	Heart/Cardiovasculature/Lymphatic
AGPS	Eye
OFD1	Skeleton
HRAS	Brain/Cognition
FKRP	Eye
COX15	Brain/Cognition
BRAF	Heart/Cardiovasculature/Lymphatic
CBL	Brain/Cognition
POMGNT1	Eye
TGFB3	Heart/Cardiovasculature/Lymphatic
GJA1	Eye
CLN3	Eye
XPC	Skeleton
MKKS	Brain/Cognition
SMARCA2	Brain/Cognition
SOX9	Genitalia
NEK8	Heart/Cardiovasculature/Lymphatic
CDC6	Ear
IFT140	Eye
SALL1	GI tract
ATP7A	Endocrine/Metabolic
BBS10	Eye
FTO	GI tract
GBA	Endocrine/Metabolic
POMT2	Eye
IFT172	Brain/Cognition
CC2D2A	Brain/Cognition
INPP5E	Genitalia
SLC46A1	Brain/Cognition
DMPK	Eye
AGA	Brain/Cognition
COL11A2	Eye
MRPS22	Brain/Cognition
PITX2	GI tract
PEX13	Endocrine/Metabolic
COL9A1	Eye
BBS4	Eye
EYA1	Ear
SNAP29	Brain/Cognition
TBX1	Heart/Cardiovasculature/Lymphatic
ALDH18A1	Brain/Cognition
TCTN2	Brain/Cognition
PIK3R1	Eye
VPS13B	Brain/Cognition
ERCC3	Brain/Cognition
SMPD1	GI tract
WT1	Heart/Cardiovasculature/Lymphatic
RECQL4	Skeleton
DVL1	Genitalia
MASP1	Brain/Cognition
ROR2	Genitalia
BCOR	Heart/Cardiovasculature/Lymphatic
ADAMTS18	Eye
PDSS1	Heart/Cardiovasculature/Lymphatic
FREM2	Eye
ALG1	GI tract
POLD1	Genitalia
GNPTAB	Brain/Cognition
SLC35C1	Brain/Cognition
SATB2	Brain/Cognition
SNX3	Eye
KRIT1	Heart/Cardiovasculature/Lymphatic
PEX5	Endocrine/Metabolic
IKBKG	Heart/Cardiovasculature/Lymphatic
FH	Brain/Cognition
OCRL	Brain/Cognition
EVC	Heart/Cardiovasculature/Lymphatic
SMARCB1	Brain/Cognition
SH3PXD2B	Heart/Cardiovasculature/Lymphatic
KAT6B	Genitalia
GLI3	Brain/Cognition
PAH	Brain/Cognition
TGFBR1	Heart/Cardiovasculature/Lymphatic
FKTN	Eye
COQ4	Heart/Cardiovasculature/Lymphatic
ASAH1	Brain/Cognition
PEX14	Eye
STRA6	Respiratory tract
STAMBP	Heart/Cardiovasculature/Lymphatic
TGFBR2	Heart/Cardiovasculature/Lymphatic
PEX16	Brain/Cognition
DPM3	Brain/Cognition
DDC	GI tract
B3GALNT2	Eye
BBS5	Eye
PLOD3	Skeleton
ARID1B	Brain/Cognition
PLXND1	Heart/Cardiovasculature/Lymphatic
TRPS1	Skeleton
BMP4	Eye
MGAT2	Brain/Cognition
GALT	Eye
LYST	Kidney Renal Tract
ZEB2	GI tract
TTC8	Brain/Cognition
IFT43	GI tract
ANTXR1	Endocrine/Metabolic
EHMT1	Heart/Cardiovasculature/Lymphatic
CDT1	Ear
ERCC6	Eye
MANBA	Brain/Cognition
PTDSS1	Brain/Cognition
PEX1	Endocrine/Metabolic
RAD21	Brain/Cognition
GNPAT	Endocrine/Metabolic
HEXB	Eye
HSD17B4	Genitalia
ANKRD11	Brain/Cognition
NF1	Brain/Cognition
SMARCA4	Cancer predisposition
PEX6	Brain/Cognition
PTEN	Brain/Cognition
FGFR1	Endocrine/Metabolic
ORC1	Ear
ARL6	Brain/Cognition
IDUA	Brain/Cognition
PTPN14	Heart/Cardiovasculature/Lymphatic
BBS1	Eye
MT-TP	Brain/Cognition
ALG12	Brain/Cognition
NFIX	Respiratory tract
ERCC2	Spinal cord/Peripheral nerves
GUSB	Endocrine/Metabolic
RET	Cancer predisposition
ZMPSTE24	Skeleton
ERCC4	Skeleton
PEX26	Endocrine/Metabolic
RBM28	Brain/Cognition
PIGL	Eye
KDM6A	Skeleton
TMEM67	Brain/Cognition
MMADHC	Brain/Cognition
PEX12	Brain/Cognition
FOXF1	Heart/Cardiovasculature/Lymphatic
SOX2	Eye
KIF11	Heart/Cardiovasculature/Lymphatic
RPGRIP1L	Eye
CASK	GI tract
TFAP2B	Eye
AR	Genitalia
SALL4	Eye
HYLS1	Brain/Cognition
BANF1	Endocrine/Metabolic
ATRX	Genitalia
IFT122	Skeleton
CEP152	Brain/Cognition
TBC1D24	Ear
FAM111A	Brain/Cognition
SOX10	Spinal cord/Peripheral nerves
UMPS	Brain/Cognition
PEX19	Brain/Cognition
SLC4A4	Brain/Cognition
DSG1	Endocrine/Metabolic
RRAS	Heart/Cardiovasculature/Lymphatic
ORC4	Ear
COLEC11	Brain/Cognition
CHD7	Eye
NEU1	Brain/Cognition
PAX3	Ear
NKX2-1	Respiratory tract
SNRPB	Brain/Cognition
GNAS	Brain/Cognition
GNS	Brain/Cognition
SLC6A8	Brain/Cognition
PEX7	Endocrine/Metabolic
CEP63	Brain/Cognition
DHFR	Brain/Cognition
CA2	Brain/Cognition
ACOX1	GI tract
DHCR24	Endocrine/Metabolic
ZBTB16	Genitalia
MAP2K1	Brain/Cognition
TBCE	Brain/Cognition
TIMM8A	Ear
DCAF17	Brain/Cognition
MTRR	Brain/Cognition
TP63	Skeleton
AAAS	Eye
USP9X	Brain/Cognition
SMOC1	Brain/Cognition
SLC2A2	GI tract
LRP2	Eye
ESCO2	Brain/Cognition
CCBE1	Heart/Cardiovasculature/Lymphatic
DYNC2H1	GI tract
RAPSN	Brain/Cognition
CD151	Ear
ELOVL4	Eye
ZC4H2	Brain/Cognition
SHH	Brain/Cognition
TAT	Brain/Cognition
MNX1	GI tract
TFAP2A	Eye
FANCL	Cancer predisposition
COL11A1	Ear
FAM58A	Skeleton
KRAS	Brain/Cognition
MKS1	Brain/Cognition
COL9A2	Eye
PEX3	Brain/Cognition
PEX2	Endocrine/Metabolic
EXT1	Skeleton
KMT2D	Skeleton
UBR1	Endocrine/Metabolic
ARID1A	Brain/Cognition
MED12	GI tract
RAI1	Brain/Cognition
TMEM165	GI tract
SLC12A6	Brain/Cognition
SMS	Brain/Cognition
FTCD	Brain/Cognition
ASPA	Eye
EP300	Brain/Cognition
MYH8	Cancer predisposition
SIX5	Eye
PPT1	Eye
BRCA2	Cancer predisposition
CENPJ	Brain/Cognition
MICU1	Brain/Cognition
EPG5	Brain/Cognition
SETBP1	Brain/Cognition
CBS	Brain/Cognition
NIPBL	Skeleton
ELAC2	Heart/Cardiovasculature/Lymphatic
PTPN11	Heart/Cardiovasculature/Lymphatic
RARB	Respiratory tract
NAGLU	Brain/Cognition
PEX10	Endocrine/Metabolic
ARSB	Brain/Cognition
PEPD	Brain/Cognition
SC5D	GI tract
ALMS1	Eye
FGF10	Eye
ABHD5	Skin
FAR1	Eye
P4HB	Brain/Cognition
ANKH	Ear
ACO2	Eye
GNPTG	Brain/Cognition
PGK1	Endocrine/Metabolic
GTPBP3	Heart/Cardiovasculature/Lymphatic
ITGA3	Respiratory tract
FAH	Brain/Cognition
SMC1A	GI tract
FUCA1	Brain/Cognition
COL4A3	Ear
IDS	Brain/Cognition
BCS1L	GI tract
RAF1	Brain/Cognition
SOBP	Eye
IRX5	Skeleton
LMBRD1	Heart/Cardiovasculature/Lymphatic
OTX2	Eye
FBN1	Heart/Cardiovasculature/Lymphatic
FIG4	Brain/Cognition
MAN2B1	Brain/Cognition
RAD51C	Brain/Cognition
IGBP1	Eye
COA5	GI tract
IFIH1	Skin
SMAD4	Heart/Cardiovasculature/Lymphatic
MAF	Eye
WDPCP	Brain/Cognition
FREM1	Skeleton
CKAP2L	Brain/Cognition
POLR3B	Brain/Cognition
UBE3B	Brain/Cognition
COX10	Brain/Cognition
SOS1	Heart/Cardiovasculature/Lymphatic
TMCO1	Brain/Cognition
SDHA	Heart/Cardiovasculature/Lymphatic
ERCC5	Spinal cord/Peripheral nerves
TSC2	Brain/Cognition
PIGT	Brain/Cognition
CTDP1	Brain/Cognition
EVC2	Heart/Cardiovasculature/Lymphatic
LONP1	GI tract
ACAD9	Heart/Cardiovasculature/Lymphatic
PREPL	Brain/Cognition
DDX58	Skeleton
AKT1	Heart/Cardiovasculature/Lymphatic
TAZ	Heart/Cardiovasculature/Lymphatic
MTR	Brain/Cognition
MYCN	GI tract
KCNJ10	Ear
FANCM	Cancer predisposition
COL18A1	Eye
SCO1	Brain/Cognition
LHX3	Ear
RAB3GAP2	Genitalia
LBR	Brain/Cognition
CCDC103	Heart/Cardiovasculature/Lymphatic
CLPB	Brain/Cognition
EFTUD2	Genitalia
APTX	Eye
FKBP14	Skeleton
TSC1	Brain/Cognition
SKI	Heart/Cardiovasculature/Lymphatic
PHOX2B	GI tract
ERCC8	Brain/Cognition
DKC1	Endocrine/Metabolic
GALE	Eye
MMACHC	Brain/Cognition
BBS2	Eye
MAP2K2	Brain/Cognition
RAB23	Heart/Cardiovasculature/Lymphatic
VPS33B	GI tract
MGP	Ear
NRAS	Heart/Cardiovasculature/Lymphatic
GTF2H5	Brain/Cognition
RNF168	Brain/Cognition
BTD	Brain/Cognition
SIL1	Brain/Cognition
BBS7	Eye
ETHE1	Heart/Cardiovasculature/Lymphatic
COL3A1	Heart/Cardiovasculature/Lymphatic
ATM	Heart/Cardiovasculature/Lymphatic
DHCR7	Endocrine/Metabolic
LARP7	Face
KMT2A	Brain/Cognition
CYB5R3	Brain/Cognition
ERCC1	Brain/Cognition
FANCI	Cancer predisposition
RNF113A	Brain/Cognition
MEGF8	Heart/Cardiovasculature/Lymphatic
BBS12	Eye
MAB21L2	Eye
SLC33A1	Ear
FGD1	Genitalia
COQ8A	Brain/Cognition
XPA	Skeleton
BLM	Brain/Cognition
RAB3GAP1	Genitalia
ATP6V1B2	Brain/Cognition
PQBP1	Genitalia
COL4A4	Ear
ORC6	Ear
DDX59	GI tract
MCOLN1	Eye
TRIM37	Eye
FOXP3	Brain/Cognition
COX6B1	Brain/Cognition
PUF60	Eye
IGF1	Ear
FRAS1	Respiratory tract
PDGFRB	Skeleton
RAB18	Genitalia
PIEZO2	Respiratory tract
VIPAS39	Spinal cord/Peripheral nerves
CISD2	GI tract
DDX11	Brain/Cognition
GALNS	Brain/Cognition
HYDIN	Heart/Cardiovasculature/Lymphatic
CLN5	Eye
GPC3	Heart/Cardiovasculature/Lymphatic
SHOC2	Multisystem
EIF2AK3	Brain/Cognition
USB1	Skeleton
RIN2	Brain/Cognition
MMP21	Heart/Cardiovasculature/Lymphatic
TUBB	Face
MAPRE2	Skeleton
SCYL1	Brain/Cognition
GMNN	Ear
DKC1	Brain/Cognition
TERT	Skeleton
PARN	Skeleton
TINF2	Skeleton
CCDC115	Brain/Cognition
TANGO2	Brain/Cognition
TRIP4	Brain/Cognition
ASCC1	Brain/Cognition
DVL3	Genitalia
FGFR1	Brain/Cognition
GTF2E2	Brain/Cognition
SMG9	Heart/Cardiovasculature/Lymphatic
TBCK	Brain/Cognition
TELO2	Eye
RERE	Brain/Cognition
TRMT10C	Ear
TKT	Heart/Cardiovasculature/Lymphatic
SMO	Brain/Cognition
CDC45	Ear
POT1	Heart/Cardiovasculature/Lymphatic
PPP1CB	Brain/Cognition
ATAD3A	Eye
GORAB	Brain/Cognition
MYT1	Eye
MAP3K7	Ear
IL11RA	Heart/Cardiovasculature/Lymphatic
IL11RA	Ear
HTRA2	Heart/Cardiovasculature/Lymphatic
OTULIN	Multisystem
USP18	Multisystem
BGN	Heart/Cardiovasculature/Lymphatic
TRIT1	Brain/Cognition
IARS	GI tract
TTC25	Heart/Cardiovasculature/Lymphatic
EMG1	Brain/Cognition
SLC25A4	Heart/Cardiovasculature/Lymphatic
KIDINS220	Brain/Cognition
MYH10	Brain/Cognition
PSMD12	Brain/Cognition
CDH1	GI tract
CTNND1	GI tract
ACTB	Heart/Cardiovasculature/Lymphatic
THOC6	Brain/Cognition
DNAH5	Genitalia
ZNF462	Eye
ERF	Respiratory tract
CWC27	Brain/Cognition
TMEM260	Heart/Cardiovasculature/Lymphatic
RPS23	Ear
INPP5K	Eye: Lens
TRIP13	Brain/Cognition
COLEC10	Brain/Cognition
DHRS3	Brain/Cognition
PEX11B	Eye
YAP1	Eye
BBS9	Respiratory tract
TRIM32	Eye
OFD1	Brain/Cognition
HRAS	Heart/Cardiovasculature/Lymphatic
COX15	GI tract
CBL	Heart/Cardiovasculature/Lymphatic
MKKS	Eye
SALL1	Ear
ATP7A	Brain/Cognition
FTO	Genitalia
CC2D2A	GI tract
COL11A2	Ear
PEX13	Brain/Cognition
ERCC3	Eye
RECQL4	Eye
FREM2	Heart/Cardiovasculature/Lymphatic
PEX5	Brain/Cognition
SMARCB1	Cancer predisposition
PEX14	GI tract
STRA6	Heart/Cardiovasculature/Lymphatic
PEX16	Eye
PLOD3	Heart/Cardiovasculature/Lymphatic
GALT	GI tract
TTC8	Eye
IFT43	Heart/Cardiovasculature/Lymphatic
PEX1	Brain/Cognition
GNPAT	Brain/Cognition
PEX6	GI tract
ARL6	Eye
IDUA	GI tract
MT-TP	Eye
ERCC2	Brain/Cognition
GUSB	Brain/Cognition
ZMPSTE24	Endocrine/Metabolic
PEX26	Brain/Cognition
KDM6A	Brain/Cognition
TMEM67	GI tract
PEX12	Eye
SOX2	GI tract
RPGRIP1L	GI tract
TFAP2B	Heart/Cardiovasculature/Lymphatic
BANF1	Heart/Cardiovasculature/Lymphatic
SOX10	Ear
PEX19	Eye
SLC4A4	Eye
CHD7	Ear
NEU1	Eye
PEX7	Brain/Cognition
ACOX1	Respiratory tract
DHCR24	Brain/Cognition
MAP2K1	Heart/Cardiovasculature/Lymphatic
USP9X	Heart/Cardiovasculature/Lymphatic
SMOC1	Eye
LRP2	Ear
SHH	Eye
MKS1	Eye
COL9A2	Ear
PEX2	Brain/Cognition
KMT2D	Brain/Cognition
UBR1	Brain/Cognition
MED12	Genitalia
EPG5	Eye
CBS	Eye
NIPBL	Brain/Cognition
PEX10	Brain/Cognition
ARSB	GI tract
ALMS1	Heart/Cardiovasculature/Lymphatic
ABHD5	Eye
P4HB	Eye
PGK1	Brain/Cognition
FAH	GI tract
SMC1A	Genitalia
FUCA1	GI tract
IDS	GI tract
RAF1	Ear
IRX5	Brain/Cognition
COA5	Heart/Cardiovasculature/Lymphatic
IFIH1	Skeleton
WDPCP	Eye
FREM1	Brain/Cognition
UBE3B	GI tract
COX10	Heart/Cardiovasculature/Lymphatic
ERCC5	Brain/Cognition
PIGT	Eye
CTDP1	Eye
LONP1	Ear
DDX58	Eye
MTR	Heart/Cardiovasculature/Lymphatic
MYCN	Ear
SCO1	GI tract
CLPB	Eye
FKBP14	Ear
GALE	GI tract
MMACHC	Heart/Cardiovasculature/Lymphatic
MAP2K2	Heart/Cardiovasculature/Lymphatic
MGP	Heart/Cardiovasculature/Lymphatic
BTD	Ear
SIL1	Eye
DHCR7	Brain/Cognition
LARP7	Brain/Cognition
ERCC1	Eye
MCOLN1	GI tract
TRIM37	GI tract
COX6B1	Heart/Cardiovasculature/Lymphatic
PUF60	Brain/Cognition
FRAS1	Heart/Cardiovasculature/Lymphatic
VIPAS39	GI tract
CISD2	Ear
EIF2AK3	GI tract
TUBB	Brain/Cognition
MAPRE2	Face
TERT	Brain/Cognition
PARN	Brain/Cognition
TINF2	GI tract
TANGO2	Heart/Cardiovasculature/Lymphatic
TELO2	Brain/Cognition
RERE	Genitalia
PPP1CB	Heart/Cardiovasculature/Lymphatic
ATAD3A	Brain/Cognition
MYT1	Ear
MAP3K7	Heart/Cardiovasculature/Lymphatic
OTULIN	GI tract
USP18	Brain/Cognition
PSMD12	Heart/Cardiovasculature/Lymphatic
CDH1	Eye
CTNND1	Eye
DNAH5	Heart/Cardiovasculature/Lymphatic
ZNF462	Brain/Cognition
INPP5K	Brain/Cognition
COLEC10	Heart/Cardiovasculature/Lymphatic
PEX11B	Brain/Cognition
YAP1	Ear
COX15	Heart/Cardiovasculature/Lymphatic
MKKS	Genitalia
FTO	Heart/Cardiovasculature/Lymphatic
PEX13	GI tract
ERCC3	Ear
PEX5	GI tract
PEX14	Ear
PEX16	Ear
TTC8	Heart/Cardiovasculature/Lymphatic
PEX1	GI tract
GNPAT	Eye
PEX26	GI tract
PEX12	GI tract
PEX19	GI tract
CHD7	Heart/Cardiovasculature/Lymphatic
PEX7	GI tract
PEX2	GI tract
CBS	Heart/Cardiovasculature/Lymphatic
NIPBL	GI tract
PEX10	GI tract
IFIH1	Brain/Cognition
FREM1	Eye
ERCC5	Eye
LONP1	Genitalia
SCO1	Heart/Cardiovasculature/Lymphatic
GALE	Ear
DHCR7	Genitalia
LARP7	Heart/Cardiovasculature/Lymphatic
PUF60	Ear
TINF2	Brain/Cognition
TELO2	Ear
RERE	Ear
PEX12	Ear
PEX19	Ear
NIPBL	Genitalia
IFIH1	Eye
FREM1	GI tract
ERCC5	Ear
LONP1	Heart/Cardiovasculature/Lymphatic
PUF60	Heart/Cardiovasculature/Lymphatic
TELO2	Heart/Cardiovasculature/Lymphatic
RERE	Heart/Cardiovasculature/Lymphatic
NIPBL	Ear
NIPBL	Heart/Cardiovasculature/Lymphatic
